abakus	abakusu	MASC;INAN
abecadło	abecadła	NEUT
abiturient	abiturienta	MASC;HUM
ablatyw	ablatywu	MASC;INAN
abnegat	abnegata	MASC;HUM
abonament	abonamentu	MASC;INAN
abonent	abonenta	MASC;HUM
absolwent	absolwenta	MASC;HUM
absolwentka	absolwentki	FEM
abstynent	abstynenta	MASC;HUM
absurd	absurdu	MASC;INAN
absynt	absyntu	MASC;INAN
adapter	adaptera	MASC;INAN
adept	adepta	MASC;HUM
adiutant	adiutanta	MASC;HUM
administrator	administratora	MASC;HUM
administratorka	administratorki	FEM
adrenalina	adrenaliny	FEM
adres	adresu	MASC;INAN
adresat	adresata	MASC;HUM
adresatka	adresatki	FEM
adwent	adwentu	MASC;INAN
adwersarz	adwersarza	MASC;HUM
aerostat	aerostatu	MASC;INAN
afera	afery	FEM
afganka	afganki	FEM
afiks	afiksu	MASC;INAN
aforyzm	aforyzmu	MASC;INAN
afrodyzjak	afrodyzjaka	MASC;INAN
afrykata	afrykaty	FEM
agat	agatu	MASC;INAN
agawa	agawy	FEM
agentura	agentury	FEM
agnostyk	agnostyka	MASC;HUM
agora	agory	FEM
agrafka	agrafki	FEM
agregat	agregatu	MASC;INAN
agresja	agresji	FEM
agresor	agresora	MASC;HUM
akademik	akademika	MASC;HUM
akapit	akapitu	MASC;INAN
akcelerometr	akcelerometru	MASC;INAN
akcent	akcentu	MASC;INAN
akcjonariusz	akcjonariusza	MASC;HUM
akordeon	akordeonu	MASC;INAN
akordeonistka	akordeonistki	FEM
akrobata	akrobaty	MASC;HUM
akromegalia	akromegalii	FEM
akronim	akronimu	MASC;INAN
akt	aktu	MASC;INAN
aktor	aktora	MASC;HUM
aktywistka	aktywistki	FEM
akumulator	akumulatora	MASC;INAN
akupresura	akupresury	FEM
akupunktura	akupunktury	FEM
akuszerka	akuszerki	FEM
akuzatyw	akuzatywu	MASC;INAN
akwedukt	akweduktu	MASC;INAN
alabaster	alabastru	MASC;INAN
alanina	alaniny	FEM
alarm	alarmu	MASC;INAN
alba	alby	FEM
albanka	albanki	FEM
albatros	albatrosa	MASC;ANIM
albańczyk	albańczyka	MASC;HUM
aldehyd	aldehydu	MASC;INAN
aleja	alei	FEM
alergen	alergenu	MASC;INAN
alfa	alfy	FEM
alfabet	alfabetu	MASC;INAN
alfons	alfonsa	MASC;HUM
algorytm	algorytmu	MASC;INAN
aligator	aligatora	MASC;ANIM
alkan	alkanu	MASC;INAN
alken	alkenu	MASC;INAN
alkin	alkinu	MASC;INAN
alkoholik	alkoholika	MASC;HUM
alkomat	alkomatu	MASC;INAN
aloes	aloesu	MASC;INAN
alofon	alofonu	MASC;INAN
alpaga	alpagi	FEM
alpaka	alpaki	FEM
alrauna	alrauny	FEM
alternatywa	alternatywy	FEM
altruista	altruisty	MASC;HUM
altówka	altówki	FEM
amazonit	amazonitu	MASC;INAN
amazonka	amazonki	FEM
ambaras	ambarasu	MASC;INAN
ambasada	ambasady	FEM
ambasador	ambasadora	MASC;HUM
ambasadorka	ambasadorki	FEM
ambulans	ambulansu	MASC;INAN
ambulatorium	ambulatorium	NEUT
ameba	ameby	FEM
amerykanin	amerykanina	MASC;HUM
amerykanizm	amerykanizmu	MASC;INAN
amerykanka	amerykanki	FEM
ametyst	ametystu	MASC;INAN
amina	aminy	FEM
aminokwas	aminokwasu	MASC;INAN
amortyzator	amortyzatora	MASC;INAN
amper	ampera	MASC;INAN
amperomierz	amperomierza	MASC;INAN
amplituda	amplitudy	FEM
amulet	amuletu	MASC;INAN
anagram	anagramu	MASC;INAN
anakonda	anakondy	FEM
analfabeta	analfabety	MASC;HUM
analiza	analizy	FEM
ananas	ananasa	MASC;INAN
android	androida	MASC;ANIM
anegdota	anegdoty	FEM
aneks	aneksu	MASC;INAN
angielka	angielki	FEM
angina	anginy	FEM
anglik	anglika	MASC;HUM
anglista	anglisty	MASC;HUM
anilina	aniliny	FEM
animista	animisty	MASC;HUM
anion	anionu	MASC;INAN
anioł	anioła	MASC;ANIM
aniołek	aniołka	MASC;ANIM
anoda	anody	FEM
anons	anonsu	MASC;INAN
antena	anteny	FEM
antidotum	antidotum	NEUT
antonówka	antonówki	FEM
antycząstka	antycząstki	FEM
antygen	antygenu	MASC;INAN
antyklina	antykliny	FEM
antylopa	antylopy	FEM
antypapież	antypapieża	MASC;HUM
antyproton	antyprotonu	MASC;INAN
antyseptyk	antyseptyku	MASC;INAN
aorta	aorty	FEM
aparat	aparatu	MASC;INAN
apetyt	apetytu	MASC;INAN
apgrejd	apgrejdu	MASC;INAN
apostrof	apostrofu	MASC;INAN
apostrofa	apostrofy	FEM
apoteoza	apoteozy	FEM
apsyda	apsydy	FEM
apteka	apteki	FEM
aptekarz	aptekarza	MASC;HUM
aquapark	aquaparku	MASC;INAN
ar	ara	MASC;INAN
ara	ary	FEM
arab	araba	MASC;HUM
arabka	arabki	FEM
arabus	arabusa	MASC;HUM
aragonit	aragonitu	MASC;INAN
arbuz	arbuza	MASC;ANIM
archaizm	archaizmu	MASC;INAN
archanioł	archanioła	MASC;ANIM
archipelag	archipelagu	MASC;INAN
architekt	architekta	FEM
archiwum	archiwum	NEUT
arcybiskup	arcybiskupa	MASC;HUM
arcydzieło	arcydzieła	NEUT
areszt	aresztu	MASC;INAN
aresztant	aresztanta	MASC;HUM
arginina	argininy	FEM
aria	arii	FEM
arkada	arkady	FEM
arkusz	arkusza	MASC;INAN
armata	armaty	FEM
armeńczyk	armeńczyka	MASC;HUM
arnika	arniki	FEM
aromat	aromatu	MASC;INAN
arsenał	arsenału	MASC;INAN
arystokrata	arystokraty	MASC;HUM
asembler	asemblera	MASC;INAN
asenterunek	asenterunku	MASC;INAN
asparagina	asparaginy	FEM
aspekt	aspektu	MASC;INAN
asteroida	asteroidy	FEM
asteryzm	asteryzmu	MASC;INAN
astrolabium	astrolabium	NEUT
astrolog	astrologa	MASC;HUM
astronauta	astronauty	MASC;HUM
astronautka	astronautki	FEM
astronom	astronoma	MASC;HUM
asymptota	asymptoty	FEM
asystent	asystenta	MASC;HUM
asystentka	asystentki	FEM
atak	ataku	MASC;INAN
atarynka	atarynki	FEM
ateusz	ateusza	MASC;HUM
atmosfera	atmosfery	FEM
atom	atomu	MASC;INAN
atrapa	atrapy	FEM
atrybut	atrybutu	MASC;INAN
attyka	attyki	FEM
audytorium	audytorium	NEUT
aula	auli	FEM
aureola	aureoli	FEM
autobiografia	autobiografii	FEM
autobus	autobusu	MASC;INAN
autograf	autografu	MASC;INAN
autokar	autokaru	MASC;INAN
automat	automatu	MASC;INAN
autor	autora	MASC;HUM
autorytaryzm	autorytaryzmu	MASC;INAN
autostop	autostopu	MASC;INAN
autostopowicz	autostopowicza	MASC;HUM
autostrada	autostrady	FEM
awanturnik	awanturnika	MASC;HUM
azot	azotu	MASC;INAN
azotan	azotanu	MASC;INAN
azyl	azylu	MASC;INAN
babcia	babci	FEM
babeczka	babeczki	FEM
babka	babki	FEM
babunia	babuni	FEM
baca	bacy	MASC;HUM
bacówka	bacówki	FEM
bad	badu	MASC;INAN
badyl	badyla	MASC;INAN
bagatela	bagateli	FEM
bagietka	bagietki	FEM
bagnet	bagnetu	MASC;INAN
bagno	bagna	NEUT
bajgiel	bajgla	MASC;INAN
bajka	bajki	FEM
bak	baku	MASC;INAN
bakburta	bakburty	FEM
baks	baksa	MASC;ANIM
bakteriofag	bakteriofaga	MASC;ANIM
bal	balu	MASC;INAN
balast	balastu	MASC;INAN
balet	baletu	MASC;INAN
balia	balii	FEM
balkon	balkonu	MASC;INAN
balon	balonu	MASC;INAN
balustrada	balustrady	FEM
ban	bana	MASC;ANIM
bandyta	bandyty	MASC;HUM
bandzior	bandziora	MASC;HUM
bank	banku	MASC;INAN
bankiet	bankietu	MASC;INAN
banknot	banknotu	MASC;INAN
bankomat	bankomatu	MASC;INAN
bankructwo	bankructwa	NEUT
bankrut	bankruta	MASC;HUM
baobab	baobabu	MASC;INAN
barabanda	barabandy	FEM
barbarzyniec	barbarzyńca	MASC;HUM
barbarzyńca	barbarzyńcy	MASC;HUM
barbarzyństwo	barbarzyństwa	NEUT
barion	barionu	MASC;INAN
bark	barku	MASC;INAN
barka	barki	FEM
barn	barnu	MASC;INAN
barogram	barogramu	MASC;INAN
barometr	barometru	MASC;INAN
barwa	barwy	FEM
barwinek	barwinka	MASC;ANIM
baryłka	baryłki	FEM
barć	barci	FEM
barłóg	barłogu	MASC;INAN
bas	basu	MASC;INAN
basen	basenu	MASC;INAN
basior	basiora	MASC;ANIM
basista	basisty	MASC;HUM
basistka	basistki	FEM
bask	baska	MASC;HUM
baskijka	baskijki	FEM
baszta	baszty	FEM
bat	bata	MASC;INAN
batat	batata	MASC;ANIM
baton	batonu	MASC;INAN
batonik	batonika	MASC;ANIM
batuta	batuty	FEM
batyskaf	batyskafu	MASC;INAN
bawełna	bawełny	FEM
bazalt	bazaltu	MASC;INAN
bazylia	bazylii	FEM
bazylika	bazyliki	FEM
bałałajka	bałałajki	FEM
bałt	bałta	MASC;HUM
bałwan	bałwana	MASC;ANIM
bałwochwalca	bałwochwalcy	MASC;HUM
bańka	bańki	FEM
baśń	baśni	FEM
bażant	bażanta	MASC;ANIM
bażyna	bażyny	FEM
beczka	beczki	FEM
beczułka	beczułki	FEM
bednarz	bednarza	MASC;HUM
bekerel	bekerela	MASC;INAN
bekon	bekonu	MASC;INAN
belg	belga	MASC;HUM
belgijka	belgijki	FEM
bemol	bemola	MASC;INAN
benzen	benzenu	MASC;INAN
beret	beretu	MASC;INAN
berło	berła	NEUT
bez	bzu	MASC;INAN
beza	bezy	FEM
bezbożnik	bezbożnika	MASC;HUM
bezdomny	bezdomnego	MASC;HUM
bezokolicznik	bezokolicznika	MASC;INAN
bezpieczeństwo	bezpieczeństwa	NEUT
bezpiecznik	bezpiecznika	MASC;INAN
bełkot	bełkotu	MASC;INAN
bełt	bełtu	MASC;INAN
białas	białasa	MASC;HUM
białko	białka	NEUT
białogłowa	białogłowy	FEM
białorusinka	białorusinki	FEM
białorzytka	białorzytki	FEM
biba	biby	FEM
bibliograf	bibliografa	MASC;HUM
biblioteczka	biblioteczki	FEM
biblioteka	biblioteki	FEM
bibliotekarka	bibliotekarki	FEM
bibliotekarz	bibliotekarza	MASC;HUM
bibuła	bibuły	FEM
biceps	bicepsa	MASC;INAN
bicie	bicia	NEUT
biedactwo	biedactwa	NEUT
biedroneczka	biedroneczki	FEM
bieg	biegu	MASC;INAN
biegunka	biegunki	FEM
biegły	biegłego	MASC;HUM
bielik	bielika	MASC;ANIM
bieluń	bieluni	FEM
biesiada	biesiady	FEM
bieługa	bieługi	FEM
bila	bili	FEM
bilet	biletu	MASC;INAN
biodro	biodra	NEUT
biogaz	biogazu	MASC;INAN
biografia	biografii	FEM
biotop	biotopu	MASC;INAN
bis	bisu	MASC;INAN
biskup	biskupa	MASC;HUM
bitwa	bitwy	FEM
biurko	biurka	NEUT
biuro	biura	NEUT
biurowiec	biurowca	MASC;INAN
biurwa	biurwy	FEM
biustonosz	biustonosza	MASC;INAN
biznes	biznesu	MASC;INAN
bizon	bizona	MASC;ANIM
blacha	blachy	FEM
blacharz	blacharza	MASC;HUM
blachosmród	blachosmroda	MASC;ANIM
blask	blasku	MASC;INAN
blenda	blendy	FEM
blizna	blizny	FEM
bliźni	bliźniego	MASC;HUM
bliźniak	bliźniaka	MASC;HUM
bliźnię	bliźnięcia	NEUT
blog	blogu	MASC;INAN
blokada	blokady	FEM
blokowisko	blokowiska	NEUT
blondyn	blondyna	MASC;HUM
bluszczyk	bluszczyku	MASC;INAN
bluza	bluzy	FEM
bluzeczka	bluzeczki	FEM
bluzka	bluzki	FEM
bobas	bobasa	MASC;HUM
bochen	bochna	MASC;INAN
bod	bodu	MASC;INAN
bogactwo	bogactwa	NEUT
bogini	bogini	FEM
bohater	bohatera	MASC;HUM
bohaterka	bohaterki	FEM
boja	boi	FEM
bok	boku	MASC;INAN
boks	boksu	MASC;INAN
boksyt	boksytu	MASC;INAN
bolec	bolca	MASC;INAN
bolid	bolidu	MASC;INAN
borowik	borowika	MASC;ANIM
borsuk	borsuka	MASC;ANIM
borówka	borówki	FEM
bosak	bosaka	MASC;INAN
boskość	boskości	FEM
bosman	bosmana	MASC;HUM
botanik	botanika	MASC;HUM
bozon	bozonu	MASC;INAN
boćwina	boćwiny	FEM
bożnica	bożnicy	FEM
brak	braku	MASC;INAN
brama	bramy	FEM
bramka	bramki	FEM
bramkarz	bramkarza	MASC;HUM
bransoleta	bransolety	FEM
bransoletka	bransoletki	FEM
branża	branży	FEM
bratanica	bratanicy	FEM
bratek	bratka	MASC;INAN
braterstwo	braterstwa	NEUT
bratobójstwo	bratobójstwa	NEUT
bratowa	bratowej	FEM
brew	brwi	FEM
brewiarz	brewiarza	MASC;INAN
brezent	brezentu	MASC;INAN
broda	brody	FEM
brodawka	brodawki	FEM
brodawnik	brodawnika	MASC;INAN
brojler	brojlera	MASC;ANIM
brokuł	brokułu	MASC;INAN
brosma	brosmy	FEM
brosza	broszy	FEM
broszura	broszury	FEM
browek	browka	MASC;ANIM
broń	broni	FEM
brud	brudu	MASC;INAN
brudas	brudasa	MASC;HUM
bruk	bruku	MASC;INAN
brukowiec	brukowca	MASC;INAN
brunet	bruneta	MASC;HUM
bruneta	brunety	FEM
brunetka	brunetki	FEM
brus	brusa	MASC;INAN
bruzda	bruzdy	FEM
brylant	brylantu	MASC;INAN
brytyjczyk	brytyjczyka	MASC;HUM
bryza	bryzy	FEM
brzask	brzasku	MASC;INAN
brzeg	brzegu	MASC;INAN
brzemię	brzemienia	NEUT
brzoskwinia	brzoskwini	FEM
brzoza	brzozy	FEM
brzuszek	brzuszka	MASC;INAN
brzydal	brzydala	MASC;HUM
brzydula	brzyduli	FEM
bród	brodu	MASC;INAN
bróg	brogu	MASC;INAN
buda	budy	FEM
buddysta	buddysty	MASC;HUM
buddystka	buddystki	FEM
budowa	budowy	FEM
budowniczy	budowniczego	MASC;HUM
budulec	budulca	MASC;INAN
budynek	budynku	MASC;INAN
budzik	budzika	MASC;INAN
budziszynianin	budziszynianina	MASC;HUM
budziszynianka	budziszynianki	FEM
budżet	budżetu	MASC;INAN
budżetówka	budżetówki	FEM
bufon	bufona	MASC;HUM
bufor	buforu	MASC;INAN
buhaj	buhaja	MASC;ANIM
bukłak	bukłaka	MASC;INAN
buldog	buldoga	MASC;ANIM
bulla	bulli	FEM
bulwa	bulwy	FEM
bulwka	bulwki	FEM
bumerang	bumerangu	MASC;INAN
bunt	buntu	MASC;INAN
burda	burdy	FEM
burka	burki	FEM
bursztyn	bursztynu	MASC;INAN
burza	burzy	FEM
burżuj	burżuja	MASC;HUM
bus	busa	MASC;ANIM
butan	butanu	MASC;INAN
buteleczka	buteleczki	FEM
butik	butiku	MASC;INAN
buziak	buziaka	MASC;ANIM
bułeczka	bułeczki	FEM
bułgar	bułgara	MASC;HUM
bułgarka	bułgarki	FEM
bułka	bułki	FEM
buńczuk	buńczuka	MASC;INAN
byt	bytu	MASC;INAN
bywalec	bywalca	MASC;HUM
była	byłej	FEM
były	byłego	MASC;HUM
bóbr	bobra	MASC;ANIM
bóg	boga	MASC;HUM
bójka	bójki	FEM
bóstwo	bóstwa	NEUT
bąbelek	bąbelka	MASC;INAN
bąk	bąka	MASC;ANIM
bęben	bębna	MASC;INAN
bękart	bękarta	MASC;ANIM
błona	błony	FEM
błonie	błonia	NEUT
błotniak	błotniaka	MASC;ANIM
błotnik	błotnika	MASC;INAN
błoto	błota	NEUT
błysk	błysku	MASC;INAN
błyskawica	błyskawicy	FEM
błąd	błędu	MASC;INAN
błękit	błękitu	MASC;INAN
cacko	cacka	NEUT
cadyk	cadyka	MASC;HUM
cal	cala	MASC;INAN
cap	capa	MASC;ANIM
car	cara	MASC;HUM
casting	castingu	MASC;INAN
całka	całki	FEM
całkowanie	całkowania	NEUT
całopalenie	całopalenia	NEUT
całun	całunu	MASC;INAN
cebrzyk	cebrzyka	MASC;INAN
cebula	cebuli	FEM
cebulka	cebulki	FEM
cech	cechu	MASC;INAN
cecha	cechy	FEM
cedr	cedru	MASC;INAN
cedzak	cedzaka	MASC;INAN
cedzidło	cedzidła	NEUT
cegiełka	cegiełki	FEM
cegła	cegły	FEM
cegłówka	cegłówki	FEM
cela	celi	FEM
celnik	celnika	MASC;HUM
celownik	celownika	MASC;INAN
celt	celta	MASC;HUM
cennik	cennika	MASC;INAN
cenobita	cenobity	MASC;HUM
cent	centa	MASC;ANIM
centrum	centrum	NEUT
centymetr	centymetra	MASC;INAN
cep	cepa	MASC;INAN
cerkiew	cerkwi	FEM
cesarka	cesarki	FEM
cesarstwo	cesarstwa	NEUT
cewa	cewy	FEM
cewka	cewki	FEM
cezar	cezara	MASC;HUM
chabeta	chabety	FEM
chan	chana	MASC;HUM
charakter	charakteru	MASC;INAN
chart	charta	MASC;ANIM
chasyd	chasyda	MASC;HUM
chata	chaty	FEM
chatka	chatki	FEM
chaus	chausa	MASC;ANIM
chałka	chałki	FEM
chałupa	chałupy	FEM
chciwość	chciwości	FEM
cheeseburger	cheeseburgera	MASC;ANIM
chemik	chemika	MASC;HUM
chinka	chinki	FEM
chleb	chleba	MASC;INAN
chloran	chloranu	MASC;INAN
chlorek	chlorku	MASC;INAN
chmurka	chmurki	FEM
chochla	chochli	FEM
chochlik	chochlika	MASC;ANIM
chodak	chodaka	MASC;INAN
chodnik	chodnika	MASC;INAN
choineczka	choineczki	FEM
choinka	choinki	FEM
cholewa	cholewy	FEM
chomik	chomika	MASC;ANIM
chomąto	chomąta	NEUT
choroba	choroby	FEM
chorwat	chorwata	MASC;HUM
choróbsko	choróbska	NEUT
chorągiew	chorągwi	FEM
chram	chramu	MASC;INAN
chromosom	chromosomu	MASC;INAN
chronolatria	chronolatrii	FEM
chrupek	chrupka	MASC;INAN
chrystadelfianin	chrystadelfianina	MASC;HUM
chrzest	chrztu	MASC;INAN
chrześcijanin	chrześcijanina	MASC;HUM
chrześniak	chrześniaka	MASC;HUM
chrząszcz	chrząszcza	MASC;ANIM
chrzęst	chrzęstu	MASC;INAN
chujnia	chujni	FEM
chusta	chusty	FEM
chusteczka	chusteczki	FEM
chwast	chwastu	MASC;INAN
chwilka	chwilki	FEM
chwilówka	chwilówki	FEM
chwyt	chwytu	MASC;INAN
chód	chodu	MASC;INAN
chór	chóru	MASC;INAN
chów	chowu	MASC;INAN
chłam	chłamu	MASC;INAN
chłodnia	chłodni	FEM
chłodnik	chłodniku	MASC;INAN
chłop	chłopa	MASC;HUM
chłopak	chłopaka	MASC;HUM
chłopczyk	chłopczyka	MASC;HUM
chłopiec	chłopca	MASC;HUM
chłosta	chłosty	FEM
ciacho	ciacha	NEUT
ciapaty	ciapatego	MASC;HUM
ciasteczko	ciasteczka	NEUT
ciastko	ciastka	NEUT
ciasto	ciasta	NEUT
ciałko	ciałka	NEUT
ciało	ciała	NEUT
ciecz	cieczy	FEM
cielsko	cielska	NEUT
cielę	cielęcia	NEUT
ciemię	ciemienia	NEUT
ciemnica	ciemnicy	FEM
ciemność	ciemności	FEM
ciepłota	ciepłoty	FEM
cierniówka	cierniówki	FEM
cierń	ciernia	MASC;INAN
ciesak	ciesaka	MASC;INAN
cieć	ciecia	MASC;HUM
cieślica	cieślicy	FEM
cieśnina	cieśniny	FEM
cinkciarz	cinkciarza	MASC;HUM
ciocia	cioci	FEM
ciosła	ciosły	FEM
ciota	cioty	FEM
ciotka	ciotki	FEM
cipa	cipy	FEM
cipeczka	cipeczki	FEM
ciuch	ciucha	MASC;INAN
ciuchcia	ciuchci	FEM
ciufcia	ciufci	FEM
ciąg	ciągu	MASC;INAN
ciągnik	ciągnika	MASC;INAN
cięciwa	cięciwy	FEM
ciężar	ciężaru	MASC;INAN
ciśnienie	ciśnienia	NEUT
cmentarz	cmentarza	MASC;INAN
cnota	cnoty	FEM
cnotka	cnotki	FEM
cokół	cokoła	MASC;INAN
cosinus	cosinusa	MASC;INAN
cotangens	cotangensa	MASC;INAN
cudo	cuda	NEUT
cudzoziemiec	cudzoziemca	MASC;HUM
cudzołóstwo	cudzołóstwa	NEUT
cudzysłów	cudzysłowu	MASC;INAN
cug	cugu	MASC;INAN
cugiel	cugla	MASC;INAN
cukier	cukru	MASC;INAN
cukiereczek	cukiereczka	MASC;ANIM
cukierek	cukierka	MASC;INAN
cukiernik	cukiernika	MASC;HUM
cukrzyca	cukrzycy	FEM
cyberprzestrzeń	cyberprzestrzeni	FEM
cyborg	cyborga	MASC;ANIM
cyc	cyca	MASC;INAN
cycek	cycka	MASC;INAN
cyfra	cyfry	FEM
cygan	cygana	MASC;HUM
cyganka	cyganki	FEM
cygaro	cygara	NEUT
cykloida	cykloidy	FEM
cymes	cymesu	MASC;INAN
cyngiel	cyngla	MASC;INAN
cynik	cynika	MASC;HUM
cynk	cynku	MASC;INAN
cyrk	cyrku	MASC;INAN
cyrulik	cyrulika	MASC;HUM
cyrylica	cyrylicy	FEM
cysteina	cysteiny	FEM
cysterna	cysterny	FEM
cytadela	cytadeli	FEM
cytat	cytatu	MASC;INAN
cytoplazma	cytoplazmy	FEM
cytra	cytry	FEM
cytrynka	cytrynki	FEM
cytwar	cytwaru	MASC;INAN
czad	czadu	MASC;INAN
czajka	czajki	FEM
czajnik	czajnika	MASC;INAN
czako	czaka	NEUT
czapeczka	czapeczki	FEM
czapla	czapli	FEM
czar	czaru	MASC;INAN
czarnoksiężnik	czarnoksiężnika	MASC;HUM
czarnoziem	czarnoziemu	MASC;INAN
czarnuch	czarnucha	MASC;HUM
czarnuszka	czarnuszki	FEM
czarny	czarnego	MASC;HUM
czarownica	czarownicy	FEM
czarownik	czarownika	MASC;HUM
czart	czarta	MASC;ANIM
czasomierz	czasomierza	MASC;INAN
czasopismo	czasopisma	NEUT
czasoprzestrzeń	czasoprzestrzeni	FEM
czasownik	czasownika	MASC;INAN
czasza	czaszy	FEM
czaszka	czaszki	FEM
czech	czecha	MASC;HUM
czek	czeku	MASC;INAN
czekan	czekana	MASC;INAN
czeladnik	czeladnika	MASC;HUM
czelesta	czelesty	FEM
czeluść	czeluści	FEM
czepek	czepka	MASC;INAN
czeremcha	czeremchy	FEM
czerep	czerepa	MASC;INAN
czereśnia	czereśni	FEM
czerniak	czerniaka	MASC;ANIM
czerpak	czerpaka	MASC;INAN
czerw	czerwia	MASC;ANIM
czerwiec	czerwca	MASC;INAN
czerwień	czerwieni	FEM
czerwony	czerwonego	MASC;ANIM
czesne	czesnego	NEUT
czeszka	czeszki	FEM
czips	czipsa	MASC;ANIM
czkawka	czkawki	FEM
czop	czopu	MASC;INAN
czopek	czopka	MASC;INAN
czort	czorta	MASC;ANIM
czosnaczek	czosnaczka	MASC;INAN
czosnek	czosnku	MASC;INAN
czoło	czoła	NEUT
czubek	czubka	MASC;ANIM
czumak	czumaka	MASC;HUM
czuwasz	czuwasza	MASC;HUM
czuwaszka	czuwaszki	FEM
czwartek	czwartku	MASC;INAN
czworokąt	czworokąta	MASC;INAN
czwórka	czwórki	FEM
czyn	czynu	MASC;INAN
czynel	czynela	MASC;INAN
czysta	czystej	FEM
czystka	czystki	FEM
czytanie	czytania	NEUT
czytelniczka	czytelniczki	FEM
czyż	czyża	MASC;ANIM
czółenko	czółenka	NEUT
czółno	czółna	NEUT
cząsteczka	cząsteczki	FEM
cząstka	cząstki	FEM
częstokół	częstokołu	MASC;INAN
członek	członka	MASC;INAN
człowieczeństwo	człowieczeństwa	NEUT
córeczka	córeczki	FEM
córka	córki	FEM
cętka	cętki	FEM
cło	cła	NEUT
dach	dachu	MASC;INAN
dachowiec	dachowca	MASC;ANIM
dachówka	dachówki	FEM
dacza	daczy	FEM
dal	dali	FEM
dalmatyńczyk	dalmatyńczyka	MASC;ANIM
dama	damy	FEM
dandys	dandysa	MASC;HUM
danie	dania	NEUT
danina	daniny	FEM
darbuka	darbuki	FEM
darowizna	darowizny	FEM
darwinista	darwinisty	MASC;HUM
daszek	daszka	MASC;INAN
dawca	dawcy	MASC;HUM
dawczyni	dawczyni	FEM
dawka	dawki	FEM
debeściak	debeściaka	MASC;HUM
decha	dechy	FEM
decymetr	decymetra	MASC;INAN
deista	deisty	MASC;HUM
dekada	dekady	FEM
dekiel	dekla	MASC;INAN
dekret	dekretu	MASC;INAN
delegat	delegata	MASC;HUM
delikwent	delikwenta	MASC;HUM
delirium	delirium	NEUT
delta	delty	FEM
deltoid	deltoidu	MASC;INAN
demagog	demagoga	MASC;HUM
demograf	demografa	MASC;HUM
demokrata	demokraty	MASC;HUM
demon	demona	MASC;ANIM
demonstrant	demonstranta	MASC;HUM
denaturat	denaturatu	MASC;INAN
dentysta	dentysty	MASC;HUM
dentystka	dentystki	FEM
depesza	depeszy	FEM
depilator	depilatora	MASC;INAN
deptak	deptaku	MASC;INAN
dermatolog	dermatologa	MASC;HUM
deseczka	deseczki	FEM
deser	deseru	MASC;INAN
deska	deski	FEM
deskarz	deskarza	MASC;HUM
deskorolka	deskorolki	FEM
despota	despoty	MASC;HUM
destylat	destylatu	MASC;INAN
deszczyk	deszczyku	MASC;INAN
deszczówka	deszczówki	FEM
detektyw	detektywa	MASC;HUM
deweloper	dewelopera	MASC;HUM
dewota	dewoty	MASC;HUM
dewotka	dewotki	FEM
dezodorant	dezodorantu	MASC;INAN
diabeł	diabła	MASC;ANIM
diagram	diagramu	MASC;INAN
diaks	diaksu	MASC;INAN
dialog	dialogu	MASC;INAN
diament	diamentu	MASC;INAN
dinar	dinara	MASC;ANIM
dinozaur	dinozaura	MASC;ANIM
dioda	diody	FEM
dj	dj-a	MASC;HUM
doba	doby	FEM
dobro	dobra	NEUT
dobytek	dobytku	MASC;INAN
docent	docenta	MASC;HUM
docentura	docentury	FEM
dochodzenie	dochodzenia	NEUT
dochód	dochodu	MASC;INAN
dodatek	dodatku	MASC;INAN
dodawanie	dodawania	NEUT
dodekan	dodekanu	MASC;INAN
dojarka	dojarki	FEM
dojrzałość	dojrzałości	FEM
doker	dokera	MASC;HUM
dokonanie	dokonania	NEUT
doktor	doktora	MASC;HUM
doktorant	doktoranta	MASC;HUM
doktorantka	doktorantki	FEM
doktorat	doktoratu	MASC;INAN
dokument	dokumentu	MASC;INAN
dolec	dolca	MASC;ANIM
dolina	doliny	FEM
dom	domu	MASC;INAN
domator	domatora	MASC;HUM
domek	domku	MASC;INAN
domena	domeny	FEM
domieszka	domieszki	FEM
domówka	domówki	FEM
donica	donicy	FEM
doniczka	doniczki	FEM
dopełniacz	dopełniacza	MASC;INAN
dopełnienie	dopełnienia	NEUT
doradca	doradcy	MASC;HUM
dorosły	dorosłego	MASC;HUM
dorzecze	dorzecza	NEUT
dostatek	dostatku	MASC;INAN
dostawczak	dostawczaka	MASC;ANIM
dotyk	dotyku	MASC;INAN
dowcip	dowcipu	MASC;INAN
dozorca	dozorcy	MASC;HUM
dozorczyni	dozorczyni	FEM
dozór	dozoru	MASC;INAN
doświadczenie	doświadczenia	NEUT
drab	draba	MASC;HUM
drabina	drabiny	FEM
dramat	dramatu	MASC;INAN
drapieżnik	drapieżnika	MASC;ANIM
drań	drania	MASC;HUM
dred	dreda	MASC;INAN
dresiarz	dresiarza	MASC;HUM
dreszcz	dreszczu	MASC;INAN
drewniak	drewniaka	MASC;INAN
drewno	drewna	NEUT
drobiazg	drobiazgu	MASC;INAN
drobina	drobiny	FEM
drobnostka	drobnostki	FEM
droga	drogi	FEM
dromader	dromadera	MASC;ANIM
drop	dropia	MASC;ANIM
drożdżówka	drożdżówki	FEM
druh	druha	MASC;HUM
drukarka	drukarki	FEM
drukarnia	drukarni	FEM
drumla	drumli	FEM
drużyna	drużyny	FEM
drzazga	drzazgi	FEM
drzemka	drzemki	FEM
drzewo	drzewa	NEUT
drzeworyt	drzeworytu	MASC;INAN
drzewostan	drzewostanu	MASC;INAN
drąg	drąga	MASC;INAN
drągal	drągala	MASC;HUM
dubeltówka	dubeltówki	FEM
duma	dumy	FEM
dunka	dunki	FEM
dupek	dupka	MASC;HUM
durszlak	durszlaka	MASC;INAN
dusiciel	dusiciela	MASC;HUM
dusza	duszy	FEM
dworka	dworki	FEM
dworzanin	dworzanina	MASC;HUM
dworzec	dworca	MASC;INAN
dwukropek	dwukropka	MASC;INAN
dwunastnica	dwunastnicy	FEM
dwusieczna	dwusiecznej	FEM
dwuznak	dwuznaku	MASC;INAN
dwójeczka	dwójeczki	FEM
dwójka	dwójki	FEM
dwór	dworu	MASC;INAN
dwórka	dwórki	FEM
dybuk	dybuka	MASC;ANIM
dycha	dychy	FEM
dyftong	dyftongu	MASC;INAN
dyktando	dyktanda	NEUT
dyktator	dyktatora	MASC;HUM
dym	dymu	MASC;INAN
dymnica	dymnicy	FEM
dynia	dyni	FEM
dyplom	dyplomu	MASC;INAN
dyrektor	dyrektora	MASC;HUM
dyrygent	dyrygenta	MASC;HUM
dyskietka	dyskietki	FEM
dyskoteka	dyskoteki	FEM
dystans	dystansu	MASC;INAN
dysydent	dysydenta	MASC;HUM
dyszel	dyszla	MASC;INAN
dywan	dywanu	MASC;INAN
dywiz	dywizu	MASC;INAN
dzban	dzbanu	MASC;INAN
dziad	dziada	MASC;HUM
dziadek	dziadka	MASC;HUM
dział	działu	MASC;INAN
działanie	działania	NEUT
działka	działki	FEM
działko	działka	NEUT
działo	działa	NEUT
dzida	dzidy	FEM
dziecię	dziecięcia	NEUT
dziecko	dziecka	NEUT
dziedzic	dziedzica	MASC;HUM
dziedzictwo	dziedzictwa	NEUT
dziedzina	dziedziny	FEM
dzielna	dzielnej	FEM
dzielnica	dzielnicy	FEM
dziennik	dziennika	MASC;INAN
dziennikarka	dziennikarki	FEM
dziennikarz	dziennikarza	MASC;HUM
dzierżawa	dzierżawy	FEM
dzierżawca	dzierżawcy	MASC;HUM
dziesięciolecie	dziesięciolecia	NEUT
dziewczyna	dziewczyny	FEM
dziewczynka	dziewczynki	FEM
dziewczę	dziewczęcia	NEUT
dziewica	dziewicy	FEM
dziewierz	dziewierza	MASC;HUM
dziewięciornik	dziewięciornika	MASC;INAN
dziewka	dziewki	FEM
dziewoja	dziewoi	FEM
dzieło	dzieła	NEUT
dzień	dnia	MASC;INAN
dzieża	dzieży	FEM
dzik	dzika	MASC;ANIM
dzikus	dzikusa	MASC;HUM
dziobak	dziobaka	MASC;ANIM
dziura	dziury	FEM
dziurawiec	dziurawca	MASC;INAN
dziureczka	dziureczki	FEM
dziurka	dziurki	FEM
dziw	dziwu	MASC;INAN
dziwak	dziwaka	MASC;HUM
dziwka	dziwki	FEM
dziób	dziobu	MASC;INAN
dziąsło	dziąsła	NEUT
dzięcielina	dzięcieliny	FEM
dzięcioł	dzięcioła	MASC;ANIM
dzwon	dzwonu	MASC;INAN
dzwonek	dzwonka	MASC;INAN
dzwoniec	dzwońca	MASC;ANIM
dzwonnica	dzwonnicy	FEM
dół	dołu	MASC;INAN
dąb	dębu	MASC;INAN
dęga	dęgi	FEM
dłoń	dłoni	FEM
dłubanka	dłubanki	FEM
długopis	długopisu	MASC;INAN
długość	długości	FEM
dłuto	dłuta	NEUT
dłużnik	dłużnika	MASC;HUM
dźwignia	dźwigni	FEM
dźwięk	dźwięku	MASC;INAN
dżdżownica	dżdżownicy	FEM
dżelada	dżelady	FEM
dżem	dżemu	MASC;INAN
dżentelmen	dżentelmena	MASC;HUM
dżezbend	dżezbendu	MASC;INAN
dżezmen	dżezmena	MASC;HUM
dżingiel	dżingla	MASC;INAN
dżinn	dżinna	MASC;HUM
dżojstik	dżojstika	MASC;INAN
dżokej	dżokeja	MASC;HUM
dżoker	dżokera	MASC;ANIM
dżudoka	dżudoki	MASC;HUM
dżungla	dżungli	FEM
e-mail	e-maila	MASC;INAN
ebonit	ebonitu	MASC;INAN
echo	echa	NEUT
edredon	edredona	MASC;ANIM
edyl	edyla	MASC;HUM
efekt	efektu	MASC;INAN
egiptolog	egiptologa	MASC;HUM
egoista	egoisty	MASC;HUM
egzamin	egzaminu	MASC;INAN
egzonim	egzonimu	MASC;INAN
egzorcysta	egzorcysty	MASC;HUM
egzosfera	egzosfery	FEM
ekierka	ekierki	FEM
ekipa	ekipy	FEM
ekonomista	ekonomisty	MASC;HUM
ekonomistka	ekonomistki	FEM
ekosystem	ekosystemu	MASC;INAN
ekran	ekranu	MASC;INAN
ekshibicjonista	ekshibicjonisty	MASC;HUM
ekspedient	ekspedienta	MASC;HUM
ekspedientka	ekspedientki	FEM
ekspertka	ekspertki	FEM
eksperyment	eksperymentu	MASC;INAN
eksport	eksportu	MASC;INAN
ekstaza	ekstazy	FEM
ekwilibrysta	ekwilibrysty	MASC;HUM
ekwilibrystka	ekwilibrystki	FEM
ekwilibrystyka	ekwilibrystyki	FEM
elektroda	elektrody	FEM
elektron	elektronu	MASC;INAN
elektronik	elektronika	MASC;HUM
elektronowolt	elektronowolta	MASC;INAN
elektrownia	elektrowni	FEM
element	elementu	MASC;INAN
elipsa	elipsy	FEM
elita	elity	FEM
embargo	embarga	NEUT
emerytura	emerytury	FEM
emir	emira	MASC;HUM
emirat	emiratu	MASC;INAN
empetrójka	empetrójki	FEM
emporium	emporium	NEUT
endonim	endonimu	MASC;INAN
enklawa	enklawy	FEM
enter	entera	MASC;INAN
entomolog	entomologa	MASC;HUM
entuzjasta	entuzjasty	MASC;HUM
enzym	enzymu	MASC;INAN
epenteza	epentezy	FEM
epifit	epifitu	MASC;INAN
epilog	epilogu	MASC;INAN
episkopat	episkopatu	MASC;INAN
epitafium	epitafium	NEUT
epitet	epitetu	MASC;INAN
epizod	epizodu	MASC;INAN
epoka	epoki	FEM
eremita	eremity	MASC;HUM
errata	erraty	FEM
erytrocyt	erytrocytu	MASC;INAN
esej	eseju	MASC;INAN
esemes	esemesa	MASC;INAN
ester	estru	MASC;INAN
esteta	estety	MASC;HUM
etan	etanu	MASC;INAN
eter	eteru	MASC;INAN
etrusk	etruska	MASC;HUM
eufemizm	eufemizmu	MASC;INAN
europejka	europejki	FEM
eutanazista	eutanazisty	MASC;HUM
ewangeliarz	ewangeliarza	MASC;INAN
fabryka	fabryki	FEM
fabuła	fabuły	FEM
fag	faga	MASC;ANIM
fagot	fagotu	MASC;INAN
fajek	fajka	MASC;ANIM
fajerwerk	fajerwerku	MASC;INAN
fajka	fajki	FEM
faks	faksu	MASC;INAN
fakt	faktu	MASC;INAN
faktura	faktury	FEM
fala	fali	FEM
falanga	falangi	FEM
fan	fana	MASC;HUM
fanatyczka	fanatyczki	FEM
fanatyk	fanatyka	MASC;HUM
fanka	fanki	FEM
fant	fantu	MASC;INAN
farad	farada	MASC;INAN
farba	farby	FEM
farfocel	farfocla	MASC;ANIM
farma	farmy	FEM
farmaceuta	farmaceuty	MASC;HUM
farmazon	farmazona	MASC;INAN
farsa	farsy	FEM
fasola	fasoli	FEM
faszysta	faszysty	MASC;HUM
fatwa	fatwy	FEM
fauna	fauny	FEM
faza	fazy	FEM
fazan	fazana	MASC;ANIM
fałszerz	fałszerza	MASC;HUM
fałszywka	fałszywki	FEM
felga	felgi	FEM
feminazistka	feminazistki	FEM
feministka	feministki	FEM
fenek	fenka	MASC;ANIM
feniks	feniksa	MASC;ANIM
fenol	fenolu	MASC;INAN
fenyloalanina	fenyloalaniny	FEM
fermion	fermionu	MASC;INAN
festiwal	festiwalu	MASC;INAN
feta	fety	FEM
ficzer	ficzeru	MASC;INAN
fideista	fideisty	MASC;HUM
figura	figury	FEM
filc	filcu	MASC;INAN
filiżaneczka	filiżaneczki	FEM
filiżanka	filiżanki	FEM
filmoteka	filmoteki	FEM
filmowiec	filmowca	MASC;HUM
filologia	filologii	FEM
filozof	filozofa	MASC;HUM
filtr	filtru	MASC;INAN
finalistka	finalistki	FEM
finał	finału	MASC;INAN
fiolet	fioletu	MASC;INAN
fiolka	fiolki	FEM
fiord	fiordu	MASC;INAN
fiołek	fiołka	MASC;INAN
firma	firmy	FEM
fizjoterapeuta	fizjoterapeuty	MASC;HUM
fizyk	fizyka	MASC;HUM
fizyka	fizyki	FEM
flaga	flagi	FEM
flak	flaku	MASC;INAN
flaming	flaminga	MASC;ANIM
flauta	flauty	FEM
flecista	flecisty	MASC;HUM
flirt	flirtu	MASC;INAN
flota	floty	FEM
foka	foki	FEM
folder	folderu	MASC;INAN
folwark	folwarku	MASC;INAN
fonem	fonemu	MASC;INAN
fonetyczka	fonetyczki	FEM
fonetyk	fonetyka	MASC;HUM
fonon	fononu	MASC;INAN
fontanna	fontanny	FEM
forint	forinta	MASC;ANIM
formalista	formalisty	MASC;HUM
fort	fortu	MASC;INAN
fortel	fortelu	MASC;INAN
fortepian	fortepianu	MASC;INAN
foryś	forysia	MASC;HUM
fosa	fosy	FEM
fosforan	fosforanu	MASC;INAN
fotograf	fotografa	MASC;HUM
foton	fotonu	MASC;INAN
fotosynteza	fotosyntezy	FEM
fraczek	fraczka	MASC;INAN
frajer	frajera	MASC;HUM
frak	fraka	MASC;INAN
francuz	francuza	MASC;HUM
francuzka	francuzki	FEM
frank	franka	MASC;ANIM
fregata	fregaty	FEM
fresk	fresku	MASC;INAN
fretka	fretki	FEM
frezer	frezera	MASC;HUM
fristajlowiec	fristajlowca	MASC;HUM
frustrat	frustrata	MASC;HUM
frytka	frytki	FEM
fryzjer	fryzjera	MASC;HUM
fryzjerka	fryzjerki	FEM
fryzura	fryzury	FEM
fuga	fugi	FEM
fuks	fuksa	MASC;INAN
fundament	fundamentu	MASC;INAN
funktor	funktora	MASC;INAN
funpag	funpaga	MASC;INAN
funt	funta	MASC;ANIM
furan	furanu	MASC;INAN
furman	furmana	MASC;HUM
furmanka	furmanki	FEM
furtka	furtki	FEM
fuszer	fuszera	MASC;HUM
futro	futra	NEUT
futrzak	futrzaka	MASC;ANIM
fuzarioza	fuzariozy	FEM
gabinet	gabinetu	MASC;INAN
gadożer	gadożera	MASC;ANIM
gadzinówka	gadzinówki	FEM
gaj	gaju	MASC;INAN
gajowy	gajowego	MASC;HUM
gala	gali	FEM
galeon	galeonu	MASC;INAN
galernik	galernika	MASC;HUM
gamepad	gamepada	MASC;INAN
ganek	ganku	MASC;INAN
garbarz	garbarza	MASC;HUM
garbus	garbusa	MASC;HUM
garderoba	garderoby	FEM
gardziel	gardzieli	FEM
gardło	gardła	NEUT
gargulec	gargulca	MASC;ANIM
garnek	garnka	MASC;INAN
garnirunek	garnirunku	MASC;INAN
garnitur	garnituru	MASC;INAN
garnizon	garnizonu	MASC;INAN
garnuszek	garnuszka	MASC;INAN
garstka	garstki	FEM
gastarbajter	gastarbajtera	MASC;HUM
gastrofaza	gastrofazy	FEM
gatunek	gatunku	MASC;INAN
gawron	gawrona	MASC;ANIM
gaz	gazu	MASC;INAN
gazela	gazeli	FEM
gazetówka	gazetówki	FEM
gałka	gałki	FEM
gałązka	gałązki	FEM
gałąź	gałęzi	FEM
gaśnica	gaśnicy	FEM
gaźnik	gaźnika	MASC;INAN
gejsza	gejszy	FEM
gekon	gekona	MASC;ANIM
gen	genu	MASC;INAN
generał	generała	MASC;HUM
geodeta	geodety	MASC;HUM
gepard	geparda	MASC;ANIM
gest	gestu	MASC;INAN
gibon	gibona	MASC;ANIM
giermek	giermka	MASC;HUM
giez	gza	MASC;ANIM
gigant	giganta	MASC;HUM
gilotyna	gilotyny	FEM
gimnazjum	gimnazjum	NEUT
gitara	gitary	FEM
gitarzysta	gitarzysty	MASC;HUM
glazura	glazury	FEM
gleba	gleby	FEM
glicyna	glicyny	FEM
glif	glifu	MASC;INAN
gliniarz	gliniarza	MASC;HUM
glon	glonu	MASC;INAN
glutamina	glutaminy	FEM
gnat	gnata	MASC;ANIM
gniazdo	gniazda	NEUT
gnębiciel	gnębiciela	MASC;HUM
gol	gola	MASC;ANIM
golarka	golarki	FEM
golfista	golfisty	MASC;HUM
golfistka	golfistki	FEM
golonka	golonki	FEM
gont	gontu	MASC;INAN
gorol	gorola	MASC;HUM
gorycz	goryczy	FEM
goryl	goryla	MASC;ANIM
gorączka	gorączki	FEM
gospoda	gospody	FEM
gospodarka	gospodarki	FEM
gołąbek	gołąbka	MASC;ANIM
gołębnik	gołębnika	MASC;INAN
gościniec	gościńca	MASC;INAN
gość	gościa	MASC;HUM
goździk	goździka	MASC;ANIM
gra	gry	FEM
grabież	grabieży	FEM
grabieżca	grabieżcy	MASC;HUM
graca	gracy	FEM
gracz	gracza	MASC;HUM
graf	grafu	MASC;INAN
grafika	grafiki	FEM
grafoskop	grafoskopu	MASC;INAN
graham	grahama	MASC;INAN
grahamka	grahamki	FEM
gram	grama	MASC;INAN
gramatyka	gramatyki	FEM
gramofon	gramofonu	MASC;INAN
granat	granatu	MASC;INAN
granatnik	granatnika	MASC;INAN
granatowiec	granatowca	MASC;INAN
graniastosłup	graniastosłupa	MASC;INAN
granica	granicy	FEM
granit	granitu	MASC;INAN
grawerowanie	grawerowania	NEUT
grawiton	grawitonu	MASC;INAN
grań	grani	FEM
grej	greja	MASC;INAN
grek	greka	MASC;HUM
grill	grilla	MASC;INAN
grindwal	grindwala	MASC;ANIM
grobowiec	grobowca	MASC;INAN
grochówka	grochówki	FEM
grom	gromu	MASC;INAN
grono	grona	NEUT
grosz	grosza	MASC;INAN
grota	groty	FEM
groza	grozy	FEM
groźba	groźby	FEM
grucha	gruchy	FEM
gruczoł	gruczołu	MASC;INAN
gruda	grudy	FEM
grudzień	grudnia	MASC;INAN
grunt	gruntu	MASC;INAN
grusza	gruszy	FEM
gruszeczka	gruszeczki	FEM
gruszyczka	gruszyczki	FEM
gruz	gruzu	MASC;INAN
gruzin	gruzina	MASC;HUM
gruzinka	gruzinki	FEM
grzbiet	grzbietu	MASC;INAN
grzebień	grzebienia	MASC;INAN
grzech	grzechu	MASC;INAN
grzechotka	grzechotki	FEM
grzechotnik	grzechotnika	MASC;ANIM
grzeczność	grzeczności	FEM
grzejnik	grzejnika	MASC;INAN
grzesiek	grześka	MASC;HUM
grzmot	grzmotu	MASC;INAN
grzybek	grzybka	MASC;ANIM
grzybień	grzybienia	MASC;INAN
grzybobranie	grzybobrania	NEUT
grzywa	grzywy	FEM
grzywna	grzywny	FEM
grób	grobu	MASC;INAN
gród	grodu	MASC;INAN
guawa	guawy	FEM
guma	gumy	FEM
gumka	gumki	FEM
gumno	gumna	NEUT
gust	gustu	MASC;INAN
guz	guza	MASC;INAN
guziec	guźca	MASC;ANIM
gułag	gułagu	MASC;INAN
gwar	gwaru	MASC;INAN
gwara	gwary	FEM
gwałciciel	gwałciciela	MASC;HUM
gwałcicielka	gwałcicielki	FEM
gwałt	gwałtu	MASC;INAN
gwiazdka	gwiazdki	FEM
gwiazdor	gwiazdora	MASC;HUM
gwiazdozbiór	gwiazdozbioru	MASC;INAN
gwint	gwintu	MASC;INAN
gwizdek	gwizdka	MASC;INAN
gwóźdź	gwóździa	MASC;INAN
gówienko	gówienka	NEUT
gówniak	gówniaka	MASC;ANIM
gówniarz	gówniarza	MASC;HUM
gówno	gówna	NEUT
gównoburza	gównoburzy	FEM
gąbka	gąbki	FEM
gąsię	gąsięcia	NEUT
gąska	gąski	FEM
gęstość	gęstości	FEM
gęstwa	gęstwy	FEM
głodówka	głodówki	FEM
głos	głosu	MASC;INAN
głoska	głoski	FEM
głosowanie	głosowania	NEUT
głowa	głowy	FEM
głowica	głowicy	FEM
głownia	głowni	FEM
głośnia	głośni	FEM
głośnik	głośnika	MASC;INAN
głośność	głośności	FEM
głuchoniemy	głuchoniemego	MASC;HUM
głupiec	głupca	MASC;HUM
głupota	głupoty	FEM
głuptas	głuptasa	MASC;HUM
głuszec	głuszca	MASC;ANIM
głód	głodu	MASC;INAN
głóg	głogu	MASC;INAN
głębia	głębi	FEM
gżegżółka	gżegżółki	FEM
habit	habitu	MASC;INAN
hacham	hachama	MASC;HUM
haczyk	haczyka	MASC;INAN
hak	haka	MASC;INAN
hala	hali	FEM
halabarda	halabardy	FEM
halerz	halerza	MASC;INAN
hamak	hamaka	MASC;INAN
hamburger	hamburgera	MASC;ANIM
handlarka	handlarki	FEM
handlarz	handlarza	MASC;HUM
haracz	haraczu	MASC;INAN
harcerz	harcerza	MASC;HUM
harem	haremu	MASC;INAN
harfa	harfy	FEM
harmonogram	harmonogramu	MASC;INAN
hasło	hasła	NEUT
haubica	haubicy	FEM
hazard	hazardu	MASC;INAN
hałas	hałasu	MASC;INAN
headshot	headshota	MASC;INAN
hebel	hebla	MASC;INAN
hedonista	hedonisty	MASC;HUM
heksametr	heksametru	MASC;INAN
heksan	heksanu	MASC;INAN
hektar	hektara	MASC;INAN
helisa	helisy	FEM
hemoliza	hemolizy	FEM
heptan	heptanu	MASC;INAN
herb	herbu	MASC;INAN
herbaciarnia	herbaciarni	FEM
herbata	herbaty	FEM
herbatka	herbatki	FEM
herbicyd	herbicydu	MASC;INAN
herc	herca	MASC;INAN
heretyk	heretyka	MASC;HUM
hetman	hetmana	MASC;ANIM
hełm	hełmu	MASC;INAN
hiena	hieny	FEM
hierarcha	hierarchy	MASC;HUM
hierarchini	hierarchini	FEM
hieroglif	hieroglifu	MASC;INAN
hindus	hindusa	MASC;HUM
hinduska	hinduski	FEM
hiperon	hiperonu	MASC;INAN
hipis	hipisa	MASC;HUM
hipodrom	hipodromu	MASC;INAN
hipopotam	hipopotama	MASC;ANIM
hipoteka	hipoteki	FEM
historyk	historyka	MASC;HUM
hiszpanka	hiszpanki	FEM
hit	hitu	MASC;INAN
hobby	hobby	NEUT
hodowla	hodowli	FEM
hokeista	hokeisty	MASC;HUM
hokejówka	hokejówki	FEM
holender	holendra	MASC;HUM
holenderka	holenderki	FEM
holownik	holownika	MASC;INAN
homar	homara	MASC;ANIM
homomorfizm	homomorfizmu	MASC;INAN
homonim	homonimu	MASC;INAN
homoseksualista	homoseksualisty	MASC;HUM
honor	honoru	MASC;INAN
horda	hordy	FEM
horoskop	horoskopu	MASC;INAN
horyzont	horyzontu	MASC;INAN
hostel	hostelu	MASC;INAN
hotel	hotelu	MASC;INAN
hołd	hołdu	MASC;INAN
hrabstwo	hrabstwa	NEUT
hreczanyk	hreczanyka	MASC;INAN
hreczka	hreczki	FEM
hrywna	hrywny	FEM
huba	huby	FEM
hufnal	hufnalu	MASC;INAN
hulajnoga	hulajnogi	FEM
humanista	humanisty	MASC;HUM
humor	humoru	MASC;INAN
hurtownia	hurtowni	FEM
husyta	husyty	MASC;HUM
huta	huty	FEM
hydraulik	hydraulika	MASC;HUM
hymn	hymnu	MASC;INAN
ibis	ibisa	MASC;ANIM
ibook	ibooka	MASC;ANIM
ichtiolog	ichtiologa	FEM
ideał	ideału	MASC;INAN
identyczność	identyczności	FEM
idiom	idiomu	MASC;INAN
igrek	igreka	MASC;INAN
iguana	iguany	FEM
igła	igły	FEM
ikebana	ikebany	FEM
ikona	ikony	FEM
ikonostas	ikonostasu	MASC;INAN
iloczyn	iloczynu	MASC;INAN
iloraz	ilorazu	MASC;INAN
ilość	ilości	FEM
imac	imaca	MASC;ANIM
imadło	imadła	NEUT
imam	imama	MASC;HUM
imbir	imbiru	MASC;INAN
imbryk	imbryka	MASC;INAN
imię	imienia	NEUT
immunitet	immunitetu	MASC;INAN
imperator	imperatora	MASC;HUM
impreza	imprezy	FEM
indianin	indianina	MASC;HUM
indonezyjczyk	indonezyjczyka	MASC;HUM
indyk	indyka	MASC;ANIM
informatyk	informatyka	MASC;HUM
infrastruktura	infrastruktury	FEM
inkaust	inkaustu	MASC;INAN
inkunabuł	inkunabułu	MASC;INAN
instytut	instytutu	MASC;INAN
insulina	insuliny	FEM
interes	interesu	MASC;INAN
internat	internatu	MASC;INAN
internista	internisty	MASC;HUM
introligator	introligatora	MASC;HUM
intryga	intrygi	FEM
iphone	iphone'a	MASC;ANIM
ipod	ipoda	MASC;ANIM
irakijczyk	irakijczyka	MASC;HUM
irakijka	irakijki	FEM
irlandczyk	irlandczyka	MASC;HUM
irlandka	irlandki	FEM
iskra	iskry	FEM
istnienie	istnienia	NEUT
istota	istoty	FEM
izba	izby	FEM
izoleucyna	izoleucyny	FEM
izotop	izotopu	MASC;INAN
izraelczyk	izraelczyka	MASC;HUM
izraelka	izraelki	FEM
ił	iłu	MASC;INAN
jabol	jabola	MASC;ANIM
jabłczan	jabłczanu	MASC;INAN
jabłecznik	jabłecznika	MASC;INAN
jabło	jabła	NEUT
jabłoń	jabłoni	FEM
jad	jadu	MASC;INAN
jadalnia	jadalni	FEM
jadło	jadła	NEUT
jadłowstręt	jadłowstrętu	MASC;INAN
jagoda	jagody	FEM
jagódeczka	jagódeczki	FEM
jagódka	jagódki	FEM
jajco	jajca	NEUT
jajko	jajka	NEUT
jajnik	jajnika	MASC;INAN
jajowód	jajowodu	MASC;INAN
jak	jaka	MASC;ANIM
jama	jamy	FEM
jamajka	jamajki	FEM
jamb	jambu	MASC;INAN
jamnik	jamnika	MASC;ANIM
jamochłon	jamochłona	MASC;ANIM
janczar	janczara	MASC;HUM
janowiec	janowca	MASC;INAN
janusz	janusza	MASC;HUM
japa	japy	FEM
japoniec	japońca	MASC;HUM
japonka	japonki	FEM
japończyk	japończyka	MASC;HUM
jar	jaru	MASC;INAN
jarmark	jarmarku	MASC;INAN
jarzmo	jarzma	NEUT
jarzynowa	jarzynowej	FEM
jarząb	jarzębu	MASC;INAN
jarząbek	jarząbka	MASC;ANIM
jarzębatka	jarzębatki	FEM
jarzębina	jarzębiny	FEM
jasnota	jasnoty	FEM
jaszczur	jaszczura	MASC;ANIM
jaszczurka	jaszczurki	FEM
jatka	jatki	FEM
jaz	jazu	MASC;INAN
jazda	jazdy	FEM
jałmużna	jałmużny	FEM
jałowiec	jałowca	MASC;INAN
jałówka	jałówki	FEM
jaśmin	jaśminu	MASC;INAN
jaźwiec	jaźwca	MASC;ANIM
jaźń	jaźni	FEM
jebadło	jebadła	NEUT
jebaka	jebaki	MASC;HUM
jednokładność	jednokładności	FEM
jednorożec	jednorożca	MASC;ANIM
jednostka	jednostki	FEM
jedwabnik	jedwabnika	MASC;ANIM
jedynak	jedynaka	MASC;HUM
jedyneczka	jedyneczki	FEM
jehowiec	jehowca	MASC;HUM
jelito	jelita	NEUT
jemioła	jemioły	FEM
jemiołuszka	jemiołuszki	FEM
jeniec	jeńca	MASC;HUM
jeremiada	jeremiady	FEM
jerzyk	jerzyka	MASC;ANIM
jesień	jesieni	FEM
jesion	jesionu	MASC;INAN
jesiotr	jesiotra	MASC;ANIM
jezdnia	jezdni	FEM
jezioro	jeziora	NEUT
jełop	jełopa	MASC;HUM
jeździec	jeźdźca	MASC;HUM
jeżowiec	jeżowca	MASC;ANIM
jeżozwierz	jeżozwierza	MASC;ANIM
jeżyk	jeżyka	MASC;ANIM
jeżyna	jeżyny	FEM
jeżówka	jeżówki	FEM
jodła	jodły	FEM
joga	jogi	FEM
joker	jokera	MASC;ANIM
jon	jonu	MASC;INAN
jonosfera	jonosfery	FEM
joypad	joypada	MASC;INAN
juhas	juhasa	MASC;HUM
junak	junaka	MASC;HUM
jupiter	jupitera	MASC;INAN
jurek	jurka	MASC;HUM
jądro	jądra	NEUT
języczek	języczka	MASC;INAN
językoznawca	językoznawcy	MASC;HUM
kabaczek	kabaczka	MASC;ANIM
kabanos	kabanosa	MASC;ANIM
kabaret	kabaretu	MASC;INAN
kabała	kabały	FEM
kabel	kabla	MASC;INAN
kablówka	kablówki	FEM
kabriolet	kabrioleta	MASC;INAN
kac	kaca	MASC;ANIM
kacenjamer	kacenjamera	MASC;INAN
kaczan	kaczana	MASC;INAN
kaczuszka	kaczuszki	FEM
kaczątko	kaczątka	NEUT
kaczę	kaczęcia	NEUT
kadzielnica	kadzielnicy	FEM
kadłub	kadłuba	MASC;INAN
kadź	kadzi	FEM
kaganiec	kagańca	MASC;INAN
kajak	kajaka	MASC;INAN
kajet	kajetu	MASC;INAN
kajman	kajmana	MASC;ANIM
kajzerka	kajzerki	FEM
kaktus	kaktusa	MASC;INAN
kalafior	kalafiora	MASC;ANIM
kalarepa	kalarepy	FEM
kaldera	kaldery	FEM
kalejdoskop	kalejdoskopu	MASC;INAN
kaleka	kaleki	FEM
kalendarz	kalendarza	MASC;INAN
kaleta	kalety	FEM
kalina	kaliny	FEM
kalka	kalki	FEM
kalkulator	kalkulatora	MASC;INAN
kalmar	kalmara	MASC;ANIM
kalorymetr	kalorymetru	MASC;INAN
kalosz	kalosza	MASC;INAN
kalwinista	kalwinisty	MASC;HUM
kameleon	kameleona	MASC;ANIM
kamera	kamery	FEM
kamerzysta	kamerzysty	MASC;HUM
kamica	kamicy	FEM
kamieniarz	kamieniarza	MASC;HUM
kamienica	kamienicy	FEM
kamieniołom	kamieniołomu	MASC;INAN
kamień	kamienia	MASC;INAN
kanadyjczyk	kanadyjczyka	MASC;HUM
kanadyjka	kanadyjki	FEM
kanapa	kanapy	FEM
kanar	kanara	MASC;HUM
kanarek	kanarka	MASC;ANIM
kanasta	kanasty	FEM
kanał	kanału	MASC;INAN
kandela	kandeli	FEM
kandelabr	kandelabru	MASC;INAN
kangur	kangura	MASC;ANIM
kania	kani	FEM
kanibal	kanibala	MASC;HUM
kanion	kanionu	MASC;INAN
kantar	kantara	MASC;INAN
kapela	kapeli	FEM
kapelan	kapelana	MASC;HUM
kapelusz	kapelusza	MASC;INAN
kapeć	kapcia	MASC;INAN
kapitalista	kapitalisty	MASC;HUM
kapitan	kapitana	MASC;HUM
kapitel	kapitla	MASC;INAN
kaplica	kaplicy	FEM
kapturka	kapturki	FEM
kapuś	kapusia	MASC;HUM
kapłan	kapłana	MASC;HUM
kara	kary	FEM
karabin	karabinu	MASC;INAN
karabinek	karabinka	MASC;INAN
karambol	karambolu	MASC;INAN
karat	karata	MASC;INAN
karawana	karawany	FEM
karaś	karasia	MASC;ANIM
karbieniec	karbieńca	MASC;INAN
karczoch	karczocha	MASC;ANIM
kardiolog	kardiologa	MASC;HUM
kardynał	kardynała	MASC;HUM
kariera	kariery	FEM
kark	karku	MASC;INAN
karma	karmy	FEM
karnista	karnisty	MASC;HUM
karo	kara	NEUT
karoca	karocy	FEM
karp	karpia	MASC;ANIM
karta	karty	FEM
karteczka	karteczki	FEM
kartka	kartki	FEM
kartkówka	kartkówki	FEM
kartofel	kartofla	MASC;INAN
karykatura	karykatury	FEM
karyna	karyny	FEM
karzeł	karła	MASC;ANIM
kasa	kasy	FEM
kasjer	kasjera	MASC;HUM
kasjerka	kasjerki	FEM
kask	kasku	MASC;INAN
kaskader	kaskadera	MASC;HUM
kasownik	kasownika	MASC;INAN
kasta	kasty	FEM
kastrat	kastrata	MASC;HUM
kasyno	kasyna	NEUT
kasza	kaszy	FEM
kaszalot	kaszalota	MASC;ANIM
kaszanka	kaszanki	FEM
kasztan	kasztana	MASC;INAN
kasztanowiec	kasztanowca	MASC;INAN
kaszubka	kaszubki	FEM
kat	kata	MASC;HUM
katabas	katabasa	MASC;HUM
katakana	katakany	FEM
katal	katalu	MASC;INAN
katalizator	katalizatora	MASC;INAN
katalończyk	katalończyka	MASC;HUM
katapulta	katapulty	FEM
katastrofa	katastrofy	FEM
katechizm	katechizmu	MASC;INAN
katedra	katedry	FEM
kation	kationu	MASC;INAN
katol	katola	MASC;HUM
kauczukowiec	kauczukowca	MASC;INAN
kawa	kawy	FEM
kawaler	kawalera	MASC;HUM
kawalik	kawalika	MASC;INAN
kawał	kawału	MASC;INAN
kawałek	kawałka	MASC;INAN
kawiarenka	kawiarenki	FEM
kawka	kawki	FEM
kawon	kawona	MASC;INAN
kawowiec	kawowca	MASC;INAN
kazanie	kazania	NEUT
kazeina	kazeiny	FEM
kaznodzieja	kaznodziei	MASC;HUM
kałamarnica	kałamarnicy	FEM
kałamarz	kałamarza	MASC;INAN
kałuża	kałuży	FEM
keczup	keczupu	MASC;INAN
kefir	kefiru	MASC;INAN
kelner	kelnera	MASC;HUM
kelnerka	kelnerki	FEM
kelwin	kelwina	MASC;INAN
ketchup	ketchupu	MASC;INAN
keton	ketonu	MASC;INAN
kibel	kibla	MASC;INAN
kibic	kibica	MASC;HUM
kibol	kibola	MASC;HUM
kicia	kici	FEM
kiciuś	kiciusia	MASC;ANIM
kicz	kiczu	MASC;INAN
kielich	kielicha	MASC;INAN
kieliszek	kieliszka	MASC;INAN
kierowca	kierowcy	MASC;HUM
kierownica	kierownicy	FEM
kierowniczka	kierowniczki	FEM
kierownik	kierownika	MASC;HUM
kierunek	kierunku	MASC;INAN
kieszeń	kieszeni	FEM
kieł	kła	MASC;INAN
kiełbasa	kiełbasy	FEM
kij	kija	MASC;INAN
kijanka	kijanki	FEM
kikut	kikuta	MASC;INAN
kilogram	kilograma	MASC;INAN
kilometr	kilometra	MASC;INAN
kilometrówka	kilometrówki	FEM
kilowatogodzina	kilowatogodziny	FEM
kimono	kimona	NEUT
kino	kina	NEUT
kirkut	kirkutu	MASC;INAN
kiszka	kiszki	FEM
kit	kitu	MASC;INAN
kitajec	kitajca	MASC;HUM
klacz	klaczy	FEM
klamka	klamki	FEM
klan	klanu	MASC;INAN
klasa	klasy	FEM
klasztor	klasztoru	MASC;INAN
klaun	klauna	MASC;HUM
klawesyn	klawesynu	MASC;INAN
klawiatura	klawiatury	FEM
klawisz	klawisza	MASC;INAN
klecha	klechy	MASC;HUM
kleik	kleiku	MASC;INAN
klej	kleju	MASC;INAN
klepisko	klepiska	NEUT
kleć	kleci	FEM
klimat	klimatu	MASC;INAN
klin	klinu	MASC;INAN
klon	klonu	MASC;INAN
klops	klopsa	MASC;INAN
klub	klubu	MASC;INAN
klucz	klucza	MASC;INAN
kluseczka	kluseczki	FEM
klątwa	klątwy	FEM
klęcznik	klęcznika	MASC;INAN
klępa	klępy	FEM
klęska	klęski	FEM
knebel	knebla	MASC;INAN
kniahini	kniahini	FEM
kniaź	kniazia	MASC;HUM
knot	knota	MASC;INAN
knur	knura	MASC;ANIM
knypek	knypka	MASC;ANIM
kobierzec	kobierca	MASC;INAN
kobra	kobry	FEM
kobyła	kobyły	FEM
koc	koca	MASC;INAN
kochanek	kochanka	MASC;HUM
kochanie	kochania	NEUT
kochanka	kochanki	FEM
kochany	kochanego	MASC;HUM
kociczka	kociczki	FEM
kociokwik	kociokwiku	MASC;INAN
kocioł	kotła	MASC;INAN
kociątko	kociątka	NEUT
kocię	kocięcia	NEUT
kocur	kocura	MASC;ANIM
kocurek	kocurka	MASC;ANIM
kod	kodu	MASC;INAN
kodeks	kodeksu	MASC;INAN
koenzym	koenzymu	MASC;INAN
kojec	kojca	MASC;INAN
kojot	kojota	MASC;ANIM
kok	koka	MASC;INAN
kokarda	kokardy	FEM
kokoryczka	kokoryczki	FEM
kokosz	kokoszy	FEM
kokot	kokota	MASC;ANIM
koktajl	koktajlu	MASC;INAN
kolano	kolana	NEUT
kolarz	kolarza	MASC;HUM
kolaż	kolażu	MASC;INAN
kolba	kolby	FEM
kolczatka	kolczatki	FEM
kolebka	kolebki	FEM
kolec	kolca	MASC;INAN
kolega	kolegi	MASC;HUM
kolej	kolei	FEM
kolejarz	kolejarza	MASC;HUM
kolejka	kolejki	FEM
kolendra	kolendry	FEM
koliber	kolibra	MASC;ANIM
kolor	koloru	MASC;INAN
kolos	kolosa	MASC;INAN
kolumbarium	kolumbarium	NEUT
kolumna	kolumny	FEM
koma	komy	FEM
komar	komara	MASC;ANIM
kombajn	kombajnu	MASC;INAN
kombinezon	kombinezonu	MASC;INAN
komenda	komendy	FEM
komentarz	komentarza	MASC;INAN
kometa	komety	FEM
komeżka	komeżki	FEM
komiks	komiksu	MASC;INAN
komin	komina	MASC;INAN
kominiarka	kominiarki	FEM
komitet	komitetu	MASC;INAN
komoda	komody	FEM
komora	komory	FEM
komp	kompa	MASC;ANIM
kompakt	kompaktu	MASC;INAN
kompas	kompasu	MASC;INAN
kompilator	kompilatora	MASC;INAN
komplement	komplementu	MASC;INAN
kompot	kompotu	MASC;INAN
komputer	komputera	MASC;INAN
komuna	komuny	FEM
komunikat	komunikatu	MASC;INAN
komunista	komunisty	MASC;HUM
komórka	komórki	FEM
koncert	koncertu	MASC;INAN
kondensator	kondensatora	MASC;INAN
kondom	kondomu	MASC;INAN
konduktor	konduktora	MASC;HUM
konew	konwi	FEM
konewka	konewki	FEM
konfitura	konfitury	FEM
konflikt	konfliktu	MASC;INAN
konformista	konformisty	MASC;HUM
kongres	kongresu	MASC;INAN
koniak	koniaku	MASC;INAN
koniczyna	koniczyny	FEM
koniec	końca	MASC;INAN
konkordat	konkordatu	MASC;INAN
konkubina	konkubiny	FEM
konkurs	konkursu	MASC;INAN
konopia	konopi	FEM
konsensus	konsensusu	MASC;INAN
konserwa	konserwy	FEM
konserwant	konserwantu	MASC;INAN
konsolidator	konsolidatora	MASC;INAN
konstantynopolitańczyk	konstantynopolitańczyka	MASC;HUM
konsulat	konsulatu	MASC;INAN
kontakt	kontaktu	MASC;INAN
kontener	kontenera	MASC;INAN
konto	konta	NEUT
kontrabas	kontrabasu	MASC;INAN
kontrprzykład	kontrprzykładu	MASC;INAN
konus	konusa	MASC;HUM
koparka	koparki	FEM
koper	kopru	MASC;INAN
koperta	koperty	FEM
kopiec	kopca	MASC;INAN
kopnięcie	kopnięcia	NEUT
kopt	kopta	MASC;HUM
kopyto	kopyta	NEUT
korab	korabia	MASC;INAN
koreańczyk	koreańczyka	MASC;HUM
korekta	korekty	FEM
korkociąg	korkociągu	MASC;INAN
kormoran	kormorana	MASC;ANIM
kornet	kornetu	MASC;INAN
kornik	kornika	MASC;ANIM
kornwalijczyk	kornwalijczyka	MASC;HUM
kornwalijka	kornwalijki	FEM
koromysło	koromysła	NEUT
korona	korony	FEM
koronka	koronki	FEM
koronnik	koronnika	MASC;ANIM
korowód	korowodu	MASC;INAN
korpus	korpusu	MASC;INAN
korsarz	korsarza	MASC;HUM
kort	kortu	MASC;INAN
korytarz	korytarza	MASC;INAN
koryto	koryta	NEUT
kosa	kosy	FEM
kosaciec	kosaćca	MASC;ANIM
kosarz	kosarza	MASC;ANIM
kosiarka	kosiarki	FEM
kosisko	kosiska	NEUT
kosmonauta	kosmonauty	MASC;HUM
kosmonautka	kosmonautki	FEM
kosmopolita	kosmopolity	MASC;HUM
kosmyk	kosmyka	MASC;INAN
kosowianin	kosowianina	MASC;HUM
kostnica	kostnicy	FEM
kostucha	kostuchy	FEM
koszt	kosztu	MASC;INAN
koszula	koszuli	FEM
koszulka	koszulki	FEM
koszyk	koszyka	MASC;INAN
koszykarka	koszykarki	FEM
koszykarz	koszykarza	MASC;HUM
kot	kota	MASC;ANIM
kotew	kotwi	FEM
kotlet	kotleta	MASC;INAN
kotwica	kotwicy	FEM
kotłownia	kotłowni	FEM
kowadło	kowadła	NEUT
kowal	kowala	MASC;HUM
koza	kozy	FEM
kozak	kozaka	MASC;HUM
koziorożec	koziorożca	MASC;ANIM
kozłek	kozłka	MASC;INAN
kołacz	kołacza	MASC;INAN
kołchoz	kołchozu	MASC;INAN
kołdra	kołdry	FEM
kołek	kołka	MASC;INAN
kołnierz	kołnierza	MASC;INAN
koło	koła	NEUT
kołowrotek	kołowrotka	MASC;INAN
kołowrót	kołowrotu	MASC;INAN
kołtun	kołtunu	MASC;INAN
kołyska	kołyski	FEM
koń	konia	MASC;ANIM
kośba	kośby	FEM
kość	kości	FEM
kra	kry	FEM
krab	kraba	MASC;ANIM
krach	krachu	MASC;INAN
kraina	krainy	FEM
krajalnica	krajalnicy	FEM
krajan	krajana	MASC;HUM
krajobraz	krajobrazu	MASC;INAN
krajzega	krajzegi	FEM
krakus	krakusa	MASC;HUM
kram	kramu	MASC;INAN
krasnodrzew	krasnodrzewu	MASC;INAN
krasnoludek	krasnoludka	MASC;ANIM
krasula	krasuli	FEM
krata	kraty	FEM
krawatka	krawatki	FEM
krawcowa	krawcowej	FEM
krawiec	krawca	MASC;HUM
krawędź	krawędzi	FEM
kreator	kreatora	MASC;INAN
kreatura	kreatury	FEM
kredyt	kredytu	MASC;INAN
krem	kremu	MASC;INAN
krematorium	krematorium	NEUT
kres	kresu	MASC;INAN
kreska	kreski	FEM
kreskówka	kreskówki	FEM
kret	kreta	MASC;ANIM
kretyn	kretyna	MASC;HUM
krewetka	krewetki	FEM
krewna	krewnej	FEM
krewny	krewnego	MASC;HUM
kreślarz	kreślarza	MASC;HUM
krochmal	krochmalu	MASC;INAN
krocze	krocza	NEUT
krogulec	krogulca	MASC;ANIM
krojczy	krojczego	MASC;HUM
krok	kroku	MASC;INAN
krokiet	krokieta	MASC;INAN
krokiew	krokwi	FEM
krokus	krokusa	MASC;INAN
kromka	kromki	FEM
kronikarz	kronikarza	MASC;HUM
kropeczka	kropeczki	FEM
kropelka	kropelki	FEM
kropidło	kropidła	NEUT
kropka	kropki	FEM
krosno	krosna	NEUT
krosta	krosty	FEM
krowa	krowy	FEM
krtań	krtani	FEM
kruch	kruchu	MASC;INAN
krucjata	krucjaty	FEM
kruczek	kruczka	MASC;INAN
krupnik	krupniku	MASC;INAN
kruszczyk	kruszczyka	MASC;INAN
kruszec	kruszcu	MASC;INAN
krwawnica	krwawnicy	FEM
krwinka	krwinki	FEM
kryjówka	kryjówki	FEM
kryminalista	kryminalisty	MASC;HUM
krynica	krynicy	FEM
krypa	krypy	FEM
krypta	krypty	FEM
kryształ	kryształu	MASC;INAN
kryterium	kryterium	NEUT
krytyka	krytyki	FEM
kryzys	kryzysu	MASC;INAN
krzak	krzaka	MASC;INAN
krzeczot	krzeczota	MASC;ANIM
krzemian	krzemianu	MASC;INAN
krzesełko	krzesełka	NEUT
krzesiwo	krzesiwa	NEUT
krzesło	krzesła	NEUT
krzew	krzewu	MASC;INAN
krzyk	krzyku	MASC;INAN
krzywa	krzywej	FEM
krzywda	krzywdy	FEM
krzywica	krzywicy	FEM
krzywizna	krzywizny	FEM
krzyżyk	krzyżyka	MASC;INAN
krój	kroju	MASC;INAN
królestwo	królestwa	NEUT
królewicz	królewicza	MASC;HUM
krótkofalówka	krótkofalówki	FEM
krówka	krówki	FEM
krąg	kręgu	MASC;INAN
krągłość	krągłości	FEM
krążownik	krążownika	MASC;INAN
kręgiel	kręgla	MASC;INAN
kręgosłup	kręgosłupa	MASC;INAN
krętogłów	krętogłowa	MASC;ANIM
ksieni	ksieni	FEM
ksiądz	księdza	MASC;HUM
książeczka	książeczki	FEM
książka	książki	FEM
książnica	książnicy	FEM
książę	księcia	MASC;HUM
księga	księgi	FEM
księgowy	księgowego	MASC;HUM
księstwo	księstwa	NEUT
księżyc	księżyca	MASC;INAN
kształt	kształtu	MASC;INAN
kszyk	kszyka	MASC;ANIM
kubek	kubka	MASC;INAN
kubeł	kubła	MASC;INAN
kucharka	kucharki	FEM
kuchenka	kuchenki	FEM
kufel	kufla	MASC;INAN
kufer	kufra	MASC;INAN
kujon	kujona	MASC;HUM
kuleczka	kuleczki	FEM
kulon	kulona	MASC;ANIM
kult	kultu	MASC;INAN
kultura	kultury	FEM
kulturysta	kulturysty	MASC;HUM
kulturystka	kulturystki	FEM
kum	kuma	MASC;HUM
kumaryna	kumaryny	FEM
kumkwat	kumkwata	MASC;INAN
kumpel	kumpla	MASC;HUM
kuna	kuny	FEM
kundel	kundla	MASC;ANIM
kupa	kupy	FEM
kuper	kupra	MASC;INAN
kupiec	kupca	MASC;HUM
kupka	kupki	FEM
kura	kury	FEM
kurator	kuratora	MASC;HUM
kurczę	kurczęcia	NEUT
kurek	kurka	MASC;INAN
kurewstwo	kurewstwa	NEUT
kurhan	kurhanu	MASC;INAN
kuriozum	kuriozum	NEUT
kurka	kurki	FEM
kurnik	kurnika	MASC;INAN
kurs	kursu	MASC;INAN
kurteczka	kurteczki	FEM
kurzajka	kurzajki	FEM
kurzawka	kurzawki	FEM
kurzyślad	kurzyśladu	MASC;INAN
kusiciel	kusiciela	MASC;HUM
kusza	kuszy	FEM
kusznik	kusznika	MASC;HUM
kuzyn	kuzyna	MASC;HUM
kwadrans	kwadransa	MASC;INAN
kwadrat	kwadratu	MASC;INAN
kwadryga	kwadrygi	FEM
kwant	kwantu	MASC;INAN
kwarc	kwarcu	MASC;INAN
kwark	kwarka	MASC;INAN
kwartał	kwartału	MASC;INAN
kwartet	kwartetu	MASC;INAN
kwas	kwasu	MASC;INAN
kwasoród	kwasorodu	MASC;INAN
kwaternion	kwaternionu	MASC;INAN
kwazar	kwazaru	MASC;INAN
kwazicząstka	kwazicząstki	FEM
kwiaciarka	kwiaciarki	FEM
kwiaciarz	kwiaciarza	MASC;HUM
kwiat	kwiatu	MASC;INAN
kwiatostan	kwiatostanu	MASC;INAN
kwiatuszek	kwiatuszka	MASC;INAN
kwiczoł	kwiczoła	MASC;ANIM
kwinta	kwinty	FEM
kwiz	kwizu	MASC;INAN
kwota	kwoty	FEM
kółko	kółka	NEUT
kądziel	kądzieli	FEM
kąkol	kąkolu	MASC;INAN
kąpiel	kąpieli	FEM
kąt	kąta	MASC;INAN
kępa	kępy	FEM
kęs	kęsa	MASC;INAN
kłak	kłaka	MASC;INAN
kłamstwo	kłamstwa	NEUT
kłoda	kłody	FEM
kłusownik	kłusownika	MASC;HUM
kłódka	kłódki	FEM
kłąb	kłębu	MASC;INAN
kłębek	kłębka	MASC;INAN
label	labela	MASC;INAN
labirynt	labiryntu	MASC;INAN
laguna	laguny	FEM
laik	laika	MASC;HUM
lakiernik	lakiernika	MASC;HUM
lakton	laktonu	MASC;INAN
laleczka	laleczki	FEM
lalka	lalki	FEM
lambda	lambdy	FEM
lampa	lampy	FEM
lampart	lamparta	MASC;ANIM
landszaft	landszaftu	MASC;INAN
langusta	langusty	FEM
lantanowiec	lantanowca	MASC;INAN
laptop	laptopu	MASC;INAN
larwa	larwy	FEM
laryngolog	laryngologa	MASC;HUM
las	lasu	MASC;INAN
lasek	lasku	MASC;INAN
laser	lasera	MASC;INAN
latarka	latarki	FEM
latarniowiec	latarniowca	MASC;INAN
latawiec	latawca	MASC;INAN
lato	lata	NEUT
lawenda	lawendy	FEM
lawina	lawiny	FEM
lazur	lazuru	MASC;INAN
leasing	leasingu	MASC;INAN
lechita	lechity	MASC;HUM
legar	legara	MASC;INAN
legenda	legendy	FEM
legion	legionu	MASC;INAN
legionista	legionisty	MASC;HUM
legowisko	legowiska	NEUT
lekarz	lekarza	MASC;HUM
lekkoatleta	lekkoatlety	MASC;HUM
leksem	leksemu	MASC;INAN
lelek	lelka	MASC;ANIM
lemat	lematu	MASC;INAN
leming	leminga	MASC;ANIM
lemniskata	lemniskaty	FEM
lemoniada	lemoniady	FEM
lemur	lemura	MASC;ANIM
len	lnu	MASC;INAN
leniwiec	leniwca	MASC;ANIM
lepra	lepry	FEM
lesba	lesby	FEM
lesbijka	lesbijki	FEM
less	lessu	MASC;INAN
leucyna	leucyny	FEM
leukocyt	leukocytu	MASC;INAN
lewa	lewy	FEM
lewak	lewaka	MASC;HUM
licealista	licealisty	MASC;HUM
liceum	liceum	NEUT
licho	licha	NEUT
lichtarz	lichtarza	MASC;INAN
lichwiarka	lichwiarki	FEM
lichwiarz	lichwiarza	MASC;HUM
lico	lica	NEUT
liczba	liczby	FEM
licznik	licznika	MASC;INAN
liczydło	liczydła	NEUT
lider	lidera	MASC;HUM
ligustr	ligustru	MASC;INAN
likaon	likaona	MASC;ANIM
lima	limy	FEM
limo	lima	NEUT
limuzyna	limuzyny	FEM
lina	liny	FEM
lincz	linczu	MASC;INAN
lingwista	lingwisty	MASC;HUM
lingwistyka	lingwistyki	FEM
linijka	linijki	FEM
link	linku	MASC;INAN
linoryt	linorytu	MASC;INAN
lipa	lipy	FEM
lipiec	lipca	MASC;INAN
lir	lira	MASC;ANIM
lira	liry	FEM
lis	lisa	MASC;ANIM
lisek	liska	MASC;ANIM
lisica	lisicy	FEM
lisiątko	lisiątka	NEUT
lisię	lisięcia	NEUT
list	listu	MASC;INAN
lista	listy	FEM
liszka	liszki	FEM
litera	litery	FEM
literówka	literówki	FEM
litr	litra	MASC;INAN
lizak	lizaka	MASC;ANIM
lizyna	lizyny	FEM
liść	liścia	MASC;INAN
loch	lochu	MASC;INAN
locha	lochy	FEM
lodowiec	lodowca	MASC;INAN
lodowisko	lodowiska	NEUT
lodziara	lodziary	FEM
lodzik	lodzika	MASC;ANIM
lodówka	lodówki	FEM
logarytm	logarytmu	MASC;INAN
logopeda	logopedy	MASC;HUM
lojalka	lojalki	FEM
lokal	lokalu	MASC;INAN
lokomotywa	lokomotywy	FEM
lokówka	lokówki	FEM
londyńczyk	londyńczyka	MASC;HUM
los	losu	MASC;INAN
lotka	lotki	FEM
lotnictwo	lotnictwa	NEUT
lotnisko	lotniska	NEUT
lotniskowiec	lotniskowca	MASC;INAN
lotos	lotosu	MASC;INAN
lubrykant	lubrykanta	MASC;INAN
ludobójstwo	ludobójstwa	NEUT
ludożerca	ludożercy	MASC;HUM
lufcik	lufcika	MASC;INAN
lugier	lugra	MASC;INAN
luka	luki	FEM
lulek	lulka	MASC;INAN
luminofor	luminoforu	MASC;INAN
lumpeks	lumpeksu	MASC;INAN
luna	luny	FEM
lupa	lupy	FEM
lusterko	lusterka	NEUT
lustro	lustra	NEUT
lustrzanka	lustrzanki	FEM
lut	lutu	MASC;INAN
lutnik	lutnika	MASC;HUM
lutownica	lutownicy	FEM
luty	lutego	MASC;INAN
lwica	lwicy	FEM
lwiątko	lwiątka	NEUT
lwię	lwięcia	NEUT
lód	lodu	MASC;INAN
ląd	lądu	MASC;INAN
lądowisko	lądowiska	NEUT
lęk	lęku	MASC;INAN
macbook	macbooka	MASC;ANIM
macedonka	macedonki	FEM
macewa	macewy	FEM
machina	machiny	FEM
macica	macicy	FEM
maciejka	maciejki	FEM
macierzanka	macierzanki	FEM
macocha	macochy	FEM
maczeta	maczety	FEM
maczuga	maczugi	FEM
mag	maga	MASC;HUM
magazyn	magazynu	MASC;INAN
magazynier	magazyniera	MASC;HUM
magisterka	magisterki	FEM
magnes	magnesu	MASC;INAN
magnetofon	magnetofonu	MASC;INAN
mahoniowiec	mahoniowca	MASC;INAN
majówka	majówki	FEM
mak	maku	MASC;INAN
makak	makaka	MASC;ANIM
makaron	makaronu	MASC;INAN
makieta	makiety	FEM
makolągwa	makolągwy	FEM
makrela	makreli	FEM
malachit	malachitu	MASC;INAN
malina	maliny	FEM
malinka	malinki	FEM
malowanie	malowania	NEUT
malowidło	malowidła	NEUT
maluch	malucha	MASC;ANIM
malunek	malunku	MASC;INAN
mamba	mamby	FEM
mamer	mamra	MASC;INAN
mamusia	mamusi	FEM
mamut	mamuta	MASC;ANIM
manat	manata	MASC;ANIM
mandaryn	mandaryna	MASC;HUM
mandarynka	mandarynki	FEM
mandolina	mandoliny	FEM
mangusta	mangusty	FEM
manicure	manicure'u	MASC;INAN
manifest	manifestu	MASC;INAN
manipuł	manipułu	MASC;INAN
mankiet	mankietu	MASC;INAN
manometr	manometru	MASC;INAN
manuskrypt	manuskryptu	MASC;INAN
mapa	mapy	FEM
mara	mary	FEM
marcepan	marcepanu	MASC;INAN
marchewka	marchewki	FEM
marchewnik	marchewnika	MASC;INAN
marionetka	marionetki	FEM
marka	marki	FEM
markiza	markizy	FEM
marmolada	marmolady	FEM
marność	marności	FEM
marsjanin	marsjanina	MASC;HUM
marskość	marskości	FEM
marszand	marszanda	MASC;HUM
marszałek	marszałka	MASC;HUM
martenzyt	martenzytu	MASC;INAN
martwica	martwicy	FEM
martwota	martwoty	FEM
marynarka	marynarki	FEM
marynarz	marynarza	MASC;HUM
marzec	marca	MASC;INAN
marzyciel	marzyciela	MASC;HUM
masa	masy	FEM
masażysta	masażysty	MASC;HUM
masażystka	masażystki	FEM
maska	maski	FEM
maskonur	maskonura	MASC;ANIM
maskowanie	maskowania	NEUT
masochista	masochisty	MASC;HUM
masowiec	masowca	MASC;INAN
masyw	masywu	MASC;INAN
maszt	masztu	MASC;INAN
maszyna	maszyny	FEM
maszynista	maszynisty	MASC;HUM
maszynopis	maszynopisu	MASC;INAN
matematyka	matematyki	FEM
materiał	materiału	MASC;INAN
matka	matki	FEM
matkojebca	matkojebcy	MASC;HUM
matryca	matrycy	FEM
matura	matury	FEM
mauzoleum	mauzoleum	NEUT
mazur	mazura	MASC;HUM
małpeczka	małpeczki	FEM
małpolud	małpoluda	MASC;HUM
małżeństwo	małżeństwa	NEUT
małżonek	małżonka	MASC;HUM
małżonka	małżonki	FEM
mańkut	mańkuta	MASC;HUM
maślanka	maślanki	FEM
maść	maści	FEM
maź	mazi	FEM
mech	mchu	MASC;INAN
mechanizm	mechanizmu	MASC;INAN
mecz	meczu	MASC;INAN
medal	medalu	MASC;INAN
medalista	medalisty	MASC;HUM
mediana	mediany	FEM
meduza	meduzy	FEM
melancholik	melancholika	MASC;HUM
melanż	melanżu	MASC;INAN
meldunek	meldunku	MASC;INAN
melina	meliny	FEM
melisa	melisy	FEM
melon	melona	MASC;ANIM
melonik	melonika	MASC;INAN
menda	mendy	FEM
menel	menela	MASC;HUM
mennica	mennicy	FEM
menora	menory	FEM
menuet	menueta	MASC;ANIM
mercedes	mercedesa	MASC;ANIM
meta	mety	FEM
metal	metalu	MASC;INAN
metan	metanu	MASC;INAN
meteorolog	meteorologa	MASC;HUM
metionina	metioniny	FEM
metr	metra	MASC;INAN
metro	metra	NEUT
metropolita	metropolity	MASC;HUM
mewa	mewy	FEM
mezon	mezonu	MASC;INAN
mezosfera	mezosfery	FEM
mgła	mgły	FEM
mgławica	mgławicy	FEM
miano	miana	NEUT
mianownik	mianownika	MASC;INAN
miara	miary	FEM
miasteczko	miasteczka	NEUT
miazga	miazgi	FEM
miał	miału	MASC;INAN
miech	miecha	MASC;INAN
miecznik	miecznika	MASC;ANIM
miednica	miednicy	FEM
miedza	miedzy	FEM
miedziak	miedziaka	MASC;ANIM
miejscownik	miejscownika	MASC;INAN
miesiąc	miesiąca	MASC;INAN
miesiączka	miesiączki	FEM
mieszaniec	mieszańca	MASC;ANIM
mieszanka	mieszanki	FEM
mieszczanin	mieszczanina	MASC;HUM
mieszkaniec	mieszkańca	MASC;HUM
migawka	migawki	FEM
migrena	migreny	FEM
mikroflora	mikroflory	FEM
mikrofon	mikrofonu	MASC;INAN
mikrokontroler	mikrokontrolera	MASC;INAN
mikroorganizm	mikroorganizmu	MASC;INAN
mikroskop	mikroskopu	MASC;INAN
mikstura	mikstury	FEM
milicjant	milicjanta	MASC;HUM
miligram	miligrama	MASC;INAN
milimetr	milimetra	MASC;INAN
milioner	milionera	MASC;HUM
mimoza	mimozy	FEM
mina	miny	FEM
minaret	minaretu	MASC;INAN
minerał	minerału	MASC;INAN
mineta	minety	FEM
ministerstwo	ministerstwa	NEUT
ministrant	ministranta	MASC;HUM
ministrantka	ministrantki	FEM
minka	minki	FEM
minus	minusa	MASC;INAN
minuta	minuty	FEM
minóg	minoga	MASC;ANIM
miodokwiat	miodokwiatu	MASC;INAN
mion	mionu	MASC;INAN
miot	miotu	MASC;INAN
miotła	miotły	FEM
misa	misy	FEM
misjonarz	misjonarza	MASC;HUM
miska	miski	FEM
mister	mistera	MASC;HUM
mistrzyni	mistrzyni	FEM
mitochondrium	mitochondrium	MASC;INAN
mięczak	mięczaka	MASC;ANIM
międzyplon	międzyplonu	MASC;INAN
mięsień	mięśnia	MASC;INAN
mięso	mięsa	NEUT
mięsożerca	mięsożercy	MASC;HUM
miłek	miłka	MASC;INAN
miłość	miłości	FEM
mleczan	mleczanu	MASC;INAN
mleczko	mleczka	NEUT
mnich	mnicha	MASC;HUM
mniejszość	mniejszości	FEM
mnożenie	mnożenia	NEUT
moc	mocy	FEM
mocarstwo	mocarstwa	NEUT
mocz	moczu	MASC;INAN
moczar	moczaru	MASC;INAN
moczowód	moczowodu	MASC;INAN
moda	mody	FEM
modem	modemu	MASC;INAN
modliszka	modliszki	FEM
modrzewnica	modrzewnicy	FEM
modzel	modzelu	MASC;INAN
modła	modły	FEM
mogiła	mogiły	FEM
molekuła	molekuły	FEM
monada	monady	FEM
monarcha	monarchy	MASC;HUM
monarchista	monarchisty	MASC;HUM
moneta	monety	FEM
monitor	monitora	MASC;INAN
monogram	monogramu	MASC;INAN
monopolista	monopolisty	MASC;HUM
monoteista	monoteisty	MASC;HUM
monsun	monsunu	MASC;INAN
montażysta	montażysty	MASC;HUM
montażystka	montażystki	FEM
monter	montera	MASC;HUM
monterka	monterki	FEM
montownia	montowni	FEM
mops	mopsa	MASC;ANIM
morale	morale	NEUT
moralniak	moralniaka	MASC;ANIM
moratorium	moratorium	NEUT
morał	morału	MASC;INAN
mord	mordu	MASC;INAN
morderca	mordercy	MASC;HUM
morderczyni	morderczyni	FEM
morderstwo	morderstwa	NEUT
mordobicie	mordobicia	NEUT
morena	moreny	FEM
mors	morsa	MASC;ANIM
morszczuk	morszczuka	MASC;ANIM
morze	morza	NEUT
morświn	morświna	MASC;ANIM
moskit	moskita	MASC;ANIM
most	mostu	MASC;INAN
mostek	mostka	MASC;INAN
moszna	moszny	FEM
motek	motka	MASC;INAN
motel	motelu	MASC;INAN
motor	motoru	MASC;INAN
motorniczy	motorniczego	MASC;HUM
motylek	motylka	MASC;ANIM
mowa	mowy	FEM
mozaika	mozaiki	FEM
mozół	mozołu	MASC;INAN
mość	mości	FEM
możliwość	możliwości	FEM
mrok	mroku	MASC;INAN
mrzonka	mrzonki	FEM
mróweczka	mróweczki	FEM
mrówka	mrówki	FEM
mrówkojad	mrówkojada	MASC;ANIM
mrówkolew	mrówkolwa	MASC;ANIM
mrównik	mrównika	MASC;ANIM
msza	mszy	FEM
mszyca	mszycy	FEM
muchomor	muchomora	MASC;ANIM
muflon	muflona	MASC;ANIM
mufti	muftiego	MASC;HUM
mundur	munduru	MASC;INAN
mundurek	mundurka	MASC;INAN
mur	muru	MASC;INAN
murek	murku	MASC;INAN
muskuł	muskułu	MASC;INAN
muslim	muslima	MASC;HUM
muszkiet	muszkietu	MASC;INAN
muszla	muszli	FEM
musztarda	musztardy	FEM
mutant	mutanta	MASC;ANIM
mutra	mutry	FEM
muza	muzy	FEM
muzeum	muzeum	NEUT
mydlnica	mydlnicy	FEM
mydło	mydła	NEUT
mysikrólik	mysikrólika	MASC;ANIM
mysz	myszy	FEM
mysza	myszy	FEM
myszka	myszki	FEM
myszołów	myszołowa	MASC;ANIM
myśl	myśli	FEM
myśliwiec	myśliwca	MASC;INAN
myśliwy	myśliwego	MASC;HUM
myślnik	myślnika	MASC;INAN
mól	mola	MASC;ANIM
mór	moru	MASC;INAN
mówca	mówcy	MASC;HUM
mózg	mózgu	MASC;INAN
móżdżek	móżdżka	MASC;INAN
mąciciel	mąciciela	MASC;HUM
mącznica	mącznicy	FEM
mądrość	mądrości	FEM
mątwa	mątwy	FEM
mąż	męża	MASC;HUM
męczennica	męczennicy	FEM
męczennik	męczennika	MASC;HUM
mędrzec	mędrca	MASC;HUM
młode	młodego	NEUT
młodziwo	młodziwa	NEUT
młotek	młotka	MASC;INAN
młyn	młyna	MASC;INAN
młynarz	młynarza	MASC;HUM
nabożeństwo	nabożeństwa	NEUT
nabycie	nabycia	NEUT
nachrapnik	nachrapnika	MASC;INAN
naczelnik	naczelnika	MASC;HUM
naczyniówka	naczyniówki	FEM
nadajnik	nadajnika	MASC;INAN
nadawca	nadawcy	MASC;HUM
nadczłowiek	nadczłowieka	MASC;HUM
nadgarstek	nadgarstka	MASC;INAN
nadmiar	nadmiaru	MASC;INAN
nadprzewodnik	nadprzewodnika	MASC;INAN
nadużycie	nadużycia	NEUT
nadzieja	nadziei	FEM
nadzorca	nadzorcy	MASC;HUM
nadzór	nadzoru	MASC;INAN
nagietek	nagietka	MASC;INAN
nagonka	nagonki	FEM
nagrobek	nagrobka	MASC;INAN
nagroda	nagrody	FEM
nagrywarka	nagrywarki	FEM
nagłówek	nagłówka	MASC;INAN
najebka	najebki	FEM
najemca	najemcy	MASC;HUM
najemnik	najemnika	MASC;HUM
nakrętka	nakrętki	FEM
nalewka	nalewki	FEM
namiot	namiotu	MASC;INAN
namiętność	namiętności	FEM
nanometr	nanometra	MASC;INAN
napad	napadu	MASC;INAN
naparstek	naparstka	MASC;INAN
naparstnica	naparstnicy	FEM
napierdalanka	napierdalanki	FEM
napis	napisu	MASC;INAN
napiwek	napiwku	MASC;INAN
napięcie	napięcia	NEUT
napletek	napletka	MASC;INAN
naradka	naradki	FEM
narkotyk	narkotyku	MASC;INAN
narta	narty	FEM
narybek	narybku	MASC;INAN
narzeczona	narzeczonej	FEM
narzeczony	narzeczonego	MASC;HUM
narzekanie	narzekania	NEUT
narząd	narządu	MASC;INAN
narzędnik	narzędnika	MASC;INAN
narzędzie	narzędzia	NEUT
naród	narodu	MASC;INAN
narów	narowu	MASC;INAN
nasieniowód	nasieniowodu	NEUT
nastolatka	nastolatki	FEM
nastrój	nastroju	MASC;INAN
następnik	następnika	MASC;INAN
naszyjnik	naszyjnika	MASC;INAN
naszywka	naszywki	FEM
nauczycielka	nauczycielki	FEM
nauka	nauki	FEM
naukowiec	naukowca	MASC;HUM
nawias	nawiasu	MASC;INAN
nawrót	nawrotu	MASC;INAN
nawóz	nawozu	MASC;INAN
nazista	nazisty	MASC;HUM
nazwa	nazwy	FEM
nazwisko	nazwiska	NEUT
nałóg	nałogu	MASC;INAN
naśladowca	naśladowcy	MASC;HUM
negatyw	negatywu	MASC;INAN
nektar	nektaru	MASC;INAN
neologizm	neologizmu	MASC;INAN
nerka	nerki	FEM
nerw	nerwu	MASC;INAN
neuron	neuronu	MASC;INAN
neutrino	neutrina	NEUT
neutron	neutronu	MASC;INAN
niania	niani	FEM
nibynóżka	nibynóżki	FEM
nicień	nicienia	MASC;ANIM
niebezpieczeństwo	niebezpieczeństwa	NEUT
nieboszczyk	nieboszczyka	MASC;HUM
niebyt	niebytu	MASC;INAN
niecierpek	niecierpka	MASC;INAN
niedopałek	niedopałka	MASC;INAN
niedorzecznik	niedorzecznika	MASC;HUM
niedostatek	niedostatku	MASC;INAN
niedziela	niedzieli	FEM
niedźwiedzica	niedźwiedzicy	FEM
niedźwiedź	niedźwiedzia	MASC;ANIM
niemka	niemki	FEM
niemota	niemoty	FEM
niepewność	niepewności	FEM
nieporządek	nieporządku	MASC;INAN
nieprawda	nieprawdy	FEM
nieruchomość	nieruchomości	FEM
niespodzianka	niespodzianki	FEM
nieuk	nieuka	MASC;HUM
niewiadoma	niewiadomej	FEM
niewidomy	niewidomego	MASC;HUM
niewolnik	niewolnika	MASC;HUM
niezapominajka	niezapominajki	FEM
nieład	nieładu	MASC;INAN
niełupka	niełupki	FEM
nimfa	nimfy	FEM
nimfomanka	nimfomanki	FEM
nioska	nioski	FEM
nirwana	nirwany	FEM
niszczyciel	niszczyciela	MASC;HUM
nit	nitu	MASC;INAN
niteczka	niteczki	FEM
niuans	niuansu	MASC;INAN
niuton	niutona	MASC;INAN
nizina	niziny	FEM
nić	nici	FEM
niż	niżu	MASC;INAN
noc	nocy	FEM
nocka	nocki	FEM
nocnik	nocnika	MASC;INAN
noga	nogi	FEM
nogawka	nogawki	FEM
nokaut	nokautu	MASC;INAN
nomada	nomady	MASC;HUM
nora	nory	FEM
nornica	nornicy	FEM
nosiciel	nosiciela	MASC;HUM
nosorożec	nosorożca	MASC;ANIM
notariusz	notariusza	MASC;HUM
notatka	notatki	FEM
notatnik	notatnika	MASC;INAN
notes	notesu	MASC;INAN
notowanie	notowania	NEUT
nowina	nowiny	FEM
nowotwór	nowotworu	MASC;INAN
nowość	nowości	FEM
nozdrze	nozdrza	NEUT
nośnik	nośnika	MASC;INAN
nożownik	nożownika	MASC;HUM
nożyk	nożyka	MASC;INAN
nukleon	nukleonu	MASC;INAN
numer	numeru	MASC;INAN
nur	nura	MASC;HUM
nurek	nurka	MASC;HUM
nów	nowiu	MASC;INAN
nóż	noża	MASC;INAN
nóżka	nóżki	FEM
nędza	nędzy	FEM
obawa	obawy	FEM
obciążenie	obciążenia	NEUT
obcokrajowiec	obcokrajowca	MASC;HUM
obcy	obcego	MASC;HUM
obczyzna	obczyzny	FEM
obelga	obelgi	FEM
obiad	obiadu	MASC;INAN
obiekt	obiektu	MASC;INAN
obietnica	obietnicy	FEM
objaw	objawu	MASC;INAN
objętość	objętości	FEM
oblicze	oblicza	NEUT
oboczność	oboczności	FEM
obojczyk	obojczyka	MASC;INAN
obora	obory	FEM
obowiązek	obowiązku	MASC;INAN
obrażenie	obrażenia	NEUT
obrona	obrony	FEM
obroża	obroży	FEM
obrzezanie	obrzezania	NEUT
obrzęd	obrzędu	MASC;INAN
obrzęk	obrzęku	MASC;INAN
obrót	obrotu	MASC;INAN
obrączka	obrączki	FEM
obręcz	obręczy	FEM
obserwator	obserwatora	MASC;HUM
obserwatorium	obserwatorium	NEUT
obsydian	obsydianu	MASC;INAN
obudowa	obudowy	FEM
obuwie	obuwia	NEUT
obuwik	obuwika	MASC;INAN
obwodnica	obwodnicy	FEM
obwód	obwodu	MASC;INAN
obywatelka	obywatelki	FEM
obóz	obozu	MASC;INAN
obłok	obłoku	MASC;INAN
obłość	obłości	FEM
ocean	oceanu	MASC;INAN
ocena	oceny	FEM
ochotnik	ochotnika	MASC;HUM
ochroniarz	ochroniarza	MASC;HUM
oczeret	oczeretu	MASC;INAN
oczopląs	oczopląsu	MASC;INAN
oda	ody	FEM
odbyt	odbytu	MASC;INAN
odcień	odcienia	MASC;INAN
oddech	oddechu	MASC;INAN
oddział	oddziału	MASC;INAN
odejmowanie	odejmowania	NEUT
odkrycie	odkrycia	NEUT
odległość	odległości	FEM
odlew	odlewu	MASC;INAN
odlot	odlotu	MASC;INAN
odmiana	odmiany	FEM
odmowa	odmowy	FEM
odnowa	odnowy	FEM
odnowiciel	odnowiciela	MASC;HUM
odpluskwiacz	odpluskwiacza	MASC;INAN
odpoczynek	odpoczynku	MASC;INAN
odporność	odporności	FEM
odpowiedź	odpowiedzi	FEM
odpływ	odpływu	MASC;INAN
odraza	odrazy	FEM
odsiecz	odsieczy	FEM
odstęp	odstępu	MASC;INAN
odszkodowanie	odszkodowania	NEUT
odtwarzacz	odtwarzacza	MASC;INAN
odwodnienie	odwodnienia	NEUT
odwrotność	odwrotności	FEM
odyniec	odyńca	MASC;ANIM
odziarniarka	odziarniarki	FEM
odźwierny	odźwiernego	MASC;HUM
odżywka	odżywki	FEM
oferta	oferty	FEM
oficer	oficera	MASC;HUM
ogar	ogara	MASC;ANIM
ogier	ogiera	MASC;ANIM
ogień	ognia	MASC;INAN
ogonek	ogonka	MASC;INAN
ogr	ogra	MASC;ANIM
ogrodniczka	ogrodniczki	FEM
ogrodnik	ogrodnika	MASC;HUM
ogrodzenie	ogrodzenia	NEUT
ogrom	ogromu	MASC;INAN
ogrzewacz	ogrzewacza	MASC;INAN
ogłoszenie	ogłoszenia	NEUT
ogłowie	ogłowia	NEUT
ohm	ohma	MASC;INAN
ojciec	ojca	MASC;HUM
ojczym	ojczyma	MASC;HUM
ojczyzna	ojczyzny	FEM
okap	okapu	MASC;INAN
okaryna	okaryny	FEM
okaz	okazu	MASC;INAN
okaziciel	okaziciela	MASC;HUM
okno	okna	NEUT
okolica	okolicy	FEM
okolicznik	okolicznika	MASC;INAN
okop	okopu	MASC;INAN
okostna	okostnej	FEM
okoń	okonia	MASC;ANIM
okrasa	okrasy	FEM
okres	okresu	MASC;INAN
okrucieństwo	okrucieństwa	NEUT
okrutnik	okrutnika	MASC;HUM
okrzyn	okrzynu	MASC;INAN
okrąg	okręgu	MASC;INAN
oksymoron	oksymoronu	MASC;INAN
oktant	oktantu	MASC;INAN
okulistka	okulistki	FEM
okup	okupu	MASC;INAN
olbrzym	olbrzyma	MASC;ANIM
olimpiada	olimpiady	FEM
oliwa	oliwy	FEM
oliwka	oliwki	FEM
olszyna	olszyny	FEM
om	oma	MASC;INAN
omam	omamu	MASC;INAN
oman	omanu	MASC;INAN
opactwo	opactwa	NEUT
opal	opalu	MASC;INAN
opalenizna	opalenizny	FEM
opat	opata	MASC;HUM
opatrunek	opatrunku	MASC;INAN
opiekun	opiekuna	MASC;HUM
opis	opisu	MASC;INAN
opiłek	opiłka	MASC;INAN
opona	opony	FEM
opornik	opornika	MASC;INAN
opowieść	opowieści	FEM
oprawa	oprawy	FEM
oprawca	oprawcy	MASC;HUM
optyk	optyka	MASC;HUM
optymistka	optymistki	FEM
opuchlizna	opuchlizny	FEM
opór	oporu	MASC;INAN
opłatek	opłatka	MASC;INAN
oracz	oracza	MASC;HUM
orbitrek	orbitreka	MASC;INAN
order	orderu	MASC;INAN
oregano	oregana	NEUT
organistka	organistki	FEM
organizator	organizatora	MASC;HUM
organizm	organizmu	MASC;INAN
orgazm	orgazmu	MASC;INAN
orka	orki	FEM
orkiestra	orkiestry	FEM
orlica	orlicy	FEM
orlik	orlika	MASC;ANIM
ormianin	ormianina	MASC;HUM
ormianka	ormianki	FEM
ornat	ornatu	MASC;INAN
ornitolog	ornitologa	MASC;HUM
ortopeda	ortopedy	MASC;HUM
orzech	orzecha	MASC;INAN
orzeczenie	orzeczenia	NEUT
orzecznik	orzecznika	MASC;INAN
orzełek	orzełka	MASC;ANIM
orędzie	orędzia	NEUT
oręż	oręża	MASC;INAN
oset	ostu	MASC;INAN
osełedec	osełedca	MASC;INAN
osiedle	osiedla	NEUT
osioł	osła	MASC;ANIM
osiągnięcie	osiągnięcia	NEUT
oskarżenie	oskarżenia	NEUT
osoba	osoby	FEM
osobnik	osobnika	MASC;ANIM
osobowość	osobowości	FEM
ostatek	ostatka	MASC;INAN
ostoja	ostoi	FEM
ostroga	ostrogi	FEM
ostrołódka	ostrołódki	FEM
ostrość	ostrości	FEM
ostryga	ostrygi	FEM
ostrzeżenie	ostrzeżenia	NEUT
ostróżka	ostróżki	FEM
oszczep	oszczepu	MASC;INAN
oszołom	oszołoma	MASC;HUM
oszust	oszusta	MASC;HUM
oszustwo	oszustwa	NEUT
osąd	osądu	MASC;INAN
otchłań	otchłani	FEM
otoczak	otoczaka	MASC;INAN
owad	owada	MASC;ANIM
owca	owcy	FEM
owoc	owocu	MASC;INAN
ozdoba	ozdoby	FEM
ołtarz	ołtarza	MASC;INAN
ołówek	ołówka	MASC;INAN
oś	osi	FEM
oścień	ościenia	MASC;INAN
oślica	oślicy	FEM
ośmiokąt	ośmiokąta	MASC;INAN
ośmiornica	ośmiornicy	FEM
ość	ości	FEM
ożyna	ożyny	FEM
pacha	pachy	FEM
pachnidło	pachnidła	NEUT
pacjent	pacjenta	MASC;HUM
pacjentka	pacjentki	FEM
pacynka	pacynki	FEM
paczka	paczki	FEM
padaczka	padaczki	FEM
pagórek	pagórka	MASC;INAN
pajac	pajaca	MASC;ANIM
pajączek	pajączka	MASC;ANIM
pająk	pająka	MASC;ANIM
pajęczak	pajęczaka	MASC;ANIM
pajęczyna	pajęczyny	FEM
pal	pala	MASC;INAN
palacz	palacza	MASC;HUM
palaczka	palaczki	FEM
palarnia	palarni	FEM
palcówka	palcówki	FEM
palec	palca	MASC;INAN
palenisko	paleniska	NEUT
paleontolog	paleontologa	FEM
palestynka	palestynki	FEM
palestyńczyk	palestyńczyka	MASC;HUM
palimpsest	palimpsestu	MASC;INAN
palindrom	palindromu	MASC;INAN
palisada	palisady	FEM
palma	palmy	FEM
palnik	palnika	MASC;INAN
pamiątka	pamiątki	FEM
pamiętnik	pamiętnika	MASC;INAN
pamięć	pamięci	FEM
pan	pana	MASC;HUM
pancerz	pancerza	MASC;INAN
panda	pandy	FEM
pandeista	pandeisty	MASC;HUM
pani	pani	FEM
panna	panny	FEM
panorama	panoramy	FEM
panteista	panteisty	MASC;HUM
pantograf	pantografu	MASC;INAN
papa	papy	FEM
papierek	papierka	MASC;INAN
papieros	papierosa	MASC;INAN
papierośnica	papierośnicy	FEM
papuga	papugi	FEM
papużka	papużki	FEM
para	pary	FEM
paradoks	paradoksu	MASC;INAN
paradygmat	paradygmatu	MASC;INAN
paragon	paragonu	MASC;INAN
paragraf	paragrafu	MASC;INAN
paranoik	paranoika	MASC;HUM
parapet	parapetu	MASC;INAN
parapetówka	parapetówki	FEM
parias	pariasa	MASC;HUM
parking	parkingu	MASC;INAN
parlament	parlamentu	MASC;INAN
parlamentarzysta	parlamentarzysty	MASC;HUM
paronim	paronimu	MASC;INAN
parowiec	parowca	MASC;INAN
parowozownia	parowozowni	FEM
parowóz	parowozu	MASC;INAN
parst	parsta	MASC;INAN
partacz	partacza	MASC;HUM
parter	parteru	MASC;INAN
partner	partnera	MASC;HUM
partnerka	partnerki	FEM
partykuła	partykuły	FEM
partyzant	partyzanta	MASC;HUM
parweniusz	parweniusza	MASC;HUM
parzydełkowiec	parzydełkowca	MASC;ANIM
parów	parowu	MASC;INAN
parówka	parówki	FEM
pasat	pasatu	MASC;INAN
pasek	paska	MASC;INAN
paserstwo	paserstwa	NEUT
pasieka	pasieki	FEM
pasierb	pasierba	MASC;HUM
pasierbica	pasierbicy	FEM
pasjans	pasjansu	MASC;ANIM
paskal	paskala	MASC;INAN
pasożyt	pasożyta	MASC;ANIM
pasterka	pasterki	FEM
pasterz	pasterza	MASC;HUM
paszcza	paszczy	FEM
paszczur	paszczura	MASC;ANIM
paszkot	paszkota	MASC;INAN
paszport	paszportu	MASC;INAN
pat	pata	MASC;ANIM
patafian	patafiana	MASC;HUM
patelnia	patelni	FEM
patent	patentu	MASC;INAN
patriarcha	patriarchy	MASC;HUM
patriota	patrioty	MASC;HUM
patriotka	patriotki	FEM
patrycjusz	patrycjusza	MASC;HUM
patyna	patyny	FEM
paw	pawia	MASC;ANIM
pawian	pawiana	MASC;ANIM
paznokieć	paznokcia	MASC;INAN
pazur	pazura	MASC;INAN
pała	pały	FEM
pałac	pałacu	MASC;INAN
pałka	pałki	FEM
państwo	państwa	NEUT
paśnik	paśnika	MASC;INAN
październik	października	MASC;INAN
pchła	pchły	FEM
pech	pecha	MASC;ANIM
pechowiec	pechowca	MASC;HUM
pedagog	pedagoga	MASC;HUM
pedalarz	pedalarza	MASC;HUM
pediatra	pediatry	MASC;HUM
pedofil	pedofila	MASC;HUM
pedryl	pedryla	MASC;HUM
pejcz	pejcza	MASC;INAN
pelikan	pelikana	MASC;ANIM
pentan	pentanu	MASC;INAN
pepik	pepika	MASC;HUM
peptyd	peptydu	MASC;INAN
pergamin	pergaminu	MASC;INAN
perkoz	perkoza	MASC;ANIM
perliczka	perliczki	FEM
peron	peronu	MASC;INAN
pers	persa	MASC;HUM
persymona	persymony	FEM
peruka	peruki	FEM
peryhelium	peryhelium	NEUT
perz	perzu	MASC;INAN
perzyna	perzyny	FEM
perła	perły	FEM
pestka	pestki	FEM
pestycyd	pestycydu	MASC;INAN
pesymista	pesymisty	MASC;HUM
pesymistka	pesymistki	FEM
pet	peta	MASC;ANIM
petarda	petardy	FEM
petent	petenta	MASC;HUM
pewnik	pewnika	MASC;INAN
pewność	pewności	FEM
pełnia	pełni	FEM
piana	piany	FEM
pianista	pianisty	MASC;HUM
pianistka	pianistki	FEM
piaskownica	piaskownicy	FEM
piasta	piasty	FEM
piczka	piczki	FEM
pidżama	pidżamy	FEM
pieczara	pieczary	FEM
pieczarka	pieczarki	FEM
pieczęć	pieczęci	FEM
piekarka	piekarki	FEM
piekarz	piekarza	MASC;HUM
piekielnik	piekielnika	MASC;HUM
piekło	piekła	NEUT
pielgrzym	pielgrzyma	MASC;HUM
pielgrzymka	pielgrzymki	FEM
pielucha	pieluchy	FEM
pieluszka	pieluszki	FEM
pielęgniarz	pielęgniarza	MASC;HUM
pieniądz	pieniądza	MASC;INAN
pierdoła	pierdoły	FEM
pierdółka	pierdółki	FEM
piernik	piernika	MASC;INAN
pierwiastek	pierwiastka	MASC;INAN
pierwszak	pierwszaka	MASC;HUM
pierwszyzna	pierwszyzny	FEM
pierś	piersi	FEM
pierścienica	pierścienicy	FEM
pierścień	pierścienia	MASC;INAN
pierścionek	pierścionka	MASC;INAN
pies	psa	MASC;ANIM
pieseczek	pieseczka	MASC;ANIM
pieszy	pieszego	MASC;HUM
pień	pnia	MASC;INAN
pieśń	pieśni	FEM
pigułka	pigułki	FEM
pijawka	pijawki	FEM
pika	piki	FEM
pikawa	pikawy	FEM
pikawka	pikawki	FEM
pilnik	pilnika	MASC;INAN
pilot	pilota	MASC;HUM
pinda	pindy	FEM
pinezka	pinezki	FEM
pingwin	pingwina	MASC;ANIM
piorun	pioruna	MASC;INAN
piosenka	piosenki	FEM
piosenkarka	piosenkarki	FEM
piosenkarz	piosenkarza	MASC;HUM
piołun	piołunu	MASC;INAN
piołunówka	piołunówki	FEM
piramida	piramidy	FEM
pirolizyna	pirolizyny	FEM
pirs	pirsu	MASC;INAN
piryt	pirytu	MASC;INAN
pisak	pisaka	MASC;INAN
pisarka	pisarki	FEM
pisarz	pisarza	MASC;HUM
pisk	pisku	MASC;INAN
pisklaczek	pisklaczka	MASC;ANIM
pisklak	pisklaka	MASC;ANIM
pisklę	pisklęcia	NEUT
pismak	pismaka	MASC;HUM
pistolet	pistoletu	MASC;INAN
piwnica	piwnicy	FEM
pizda	pizdy	FEM
pizza	pizzy	FEM
piórnik	piórnika	MASC;INAN
pióro	pióra	NEUT
piąchopiryna	piąchopiryny	FEM
piąteczka	piąteczki	FEM
pięciobój	pięcioboju	MASC;INAN
pięciokąt	pięciokąta	MASC;INAN
piędź	piędzi	FEM
piękność	piękności	FEM
pięta	pięty	FEM
piętka	piętki	FEM
pięść	pięści	FEM
piła	piły	FEM
piłeczka	piłeczki	FEM
piłka	piłki	FEM
piłkarz	piłkarza	MASC;HUM
piżama	piżamy	FEM
piżmak	piżmaka	MASC;ANIM
piżmo	piżma	NEUT
placek	placka	MASC;INAN
plaga	plagi	FEM
plakat	plakatu	MASC;INAN
plan	planu	MASC;INAN
planeta	planety	FEM
planszówka	planszówki	FEM
plask	plasku	MASC;INAN
plaster	plastra	MASC;INAN
platan	platanu	MASC;INAN
plazma	plazmy	FEM
plaża	plaży	FEM
plecak	plecaka	MASC;INAN
plemię	plemienia	NEUT
plemnik	plemnika	MASC;INAN
pleonazm	pleonazmu	MASC;INAN
pleszczotka	pleszczotki	FEM
plewa	plewy	FEM
plik	pliku	MASC;INAN
pliszka	pliszki	FEM
plomba	plomby	FEM
plotka	plotki	FEM
pluralizm	pluralizmu	MASC;INAN
pluskwa	pluskwy	FEM
pluton	plutonu	MASC;INAN
pniak	pniaka	MASC;INAN
pnącze	pnącza	NEUT
poborca	poborcy	MASC;HUM
poborowy	poborowego	MASC;HUM
pobyt	pobytu	MASC;INAN
pocałunek	pocałunku	MASC;INAN
pochodna	pochodnej	FEM
pochodnia	pochodni	FEM
pochyłość	pochyłości	FEM
pochówek	pochówka	MASC;INAN
pociecha	pociechy	FEM
pociąg	pociągu	MASC;INAN
poczekalnia	poczekalni	FEM
poczet	pocztu	MASC;INAN
poczwarka	poczwarki	FEM
początek	początku	MASC;INAN
poczęstunek	poczęstunku	MASC;INAN
podanie	podania	NEUT
podatek	podatku	MASC;INAN
podbiał	podbiału	MASC;INAN
podbródek	podbródka	MASC;INAN
podcast	podcastu	MASC;INAN
poddasze	poddasza	NEUT
podeszwa	podeszwy	FEM
podgrupa	podgrupy	FEM
podkoszulek	podkoszulka	MASC;INAN
podkowa	podkowy	FEM
podkreślenie	podkreślenia	NEUT
podkówka	podkówki	FEM
podmiot	podmiotu	MASC;INAN
podniebienie	podniebienia	NEUT
podnieta	podniety	FEM
podobieństwo	podobieństwa	NEUT
podpalacz	podpalacza	MASC;HUM
podpalenie	podpalenia	NEUT
podpis	podpisu	MASC;INAN
podróbka	podróbki	FEM
podróż	podróży	FEM
podręcznik	podręcznika	MASC;INAN
podstęp	podstępu	MASC;INAN
podtytuł	podtytułu	MASC;INAN
poducha	poduchy	FEM
poduszka	poduszki	FEM
podwieczorek	podwieczorka	MASC;INAN
podwiązka	podwiązki	FEM
podwórko	podwórka	NEUT
podzbiór	podzbioru	MASC;INAN
poetka	poetki	FEM
poganin	poganina	MASC;HUM
pogląd	poglądu	MASC;INAN
pogoda	pogody	FEM
pogotowie	pogotowia	NEUT
pogrom	pogromu	MASC;INAN
pogrzeb	pogrzebu	MASC;INAN
pojazd	pojazdu	MASC;INAN
pojedynek	pojedynku	MASC;INAN
pojemnik	pojemnika	MASC;INAN
pojęcie	pojęcia	NEUT
pokaz	pokazu	MASC;INAN
pokojówka	pokojówki	FEM
pokolenie	pokolenia	NEUT
pokos	pokosu	MASC;INAN
pokrzywa	pokrzywy	FEM
pokusa	pokusy	FEM
pokuta	pokuty	FEM
pokład	pokładu	MASC;INAN
polaczek	polaczka	MASC;HUM
polak	polaka	MASC;HUM
polana	polany	FEM
polano	polana	NEUT
polecenie	polecenia	NEUT
polewka	polewki	FEM
policjant	policjanta	MASC;HUM
policjantka	policjantki	FEM
policzek	policzka	MASC;INAN
poliester	poliestru	MASC;INAN
poligamista	poligamisty	MASC;HUM
poligamistka	poligamistki	FEM
polimer	polimeru	MASC;INAN
polisacharyd	polisacharydu	MASC;INAN
polisomia	polisomii	FEM
politechnika	politechniki	FEM
polka	polki	FEM
polonez	poloneza	MASC;ANIM
polowanie	polowania	NEUT
polędwica	polędwicy	FEM
pomidor	pomidora	MASC;INAN
pomnik	pomnika	MASC;INAN
pomoc	pomocy	FEM
pomocnik	pomocnika	MASC;HUM
pompa	pompy	FEM
pomysł	pomysłu	MASC;INAN
pomyłka	pomyłki	FEM
poncz	ponczu	MASC;INAN
poniedziałek	poniedziałku	MASC;INAN
pontyfikat	pontyfikatu	MASC;INAN
popielniczka	popielniczki	FEM
popiersie	popiersia	NEUT
popiół	popiołu	MASC;INAN
popołudnie	popołudnia	NEUT
poprawczak	poprawczaka	MASC;INAN
popręg	popręgu	MASC;INAN
populista	populisty	MASC;HUM
popychadło	popychadła	NEUT
por	pora	MASC;INAN
pora	pory	FEM
poradnik	poradnika	MASC;INAN
poranek	poranka	MASC;INAN
porażka	porażki	FEM
pornograf	pornografa	MASC;HUM
pornol	pornola	MASC;ANIM
porodówka	porodówki	FEM
poronienie	poronienia	NEUT
porozumienie	porozumienia	NEUT
poroże	poroża	NEUT
port	portu	MASC;INAN
portal	portalu	MASC;INAN
portmonetka	portmonetki	FEM
portowiec	portowca	MASC;HUM
portrecista	portrecisty	MASC;HUM
portret	portretu	MASC;INAN
porządek	porządku	MASC;INAN
poród	porodu	MASC;INAN
porównywarka	porównywarki	FEM
posada	posady	FEM
posag	posagu	MASC;INAN
poseł	posła	MASC;HUM
posiadłość	posiadłości	FEM
posiedzenie	posiedzenia	NEUT
posiłek	posiłku	MASC;INAN
postać	postaci	FEM
postęp	postępu	MASC;INAN
poszkodowany	poszkodowanego	MASC;HUM
posąg	posągu	MASC;INAN
posążek	posążka	MASC;INAN
posłaniec	posłańca	MASC;HUM
posłanka	posłanki	FEM
potakiwacz	potakiwacza	MASC;HUM
potańcówka	potańcówki	FEM
potencjał	potencjału	MASC;INAN
potok	potoku	MASC;INAN
potomek	potomka	MASC;HUM
potop	potopu	MASC;INAN
potrawa	potrawy	FEM
potwarz	potwarzy	FEM
potwór	potwora	MASC;ANIM
potylica	potylicy	FEM
potęga	potęgi	FEM
powiat	powiatu	MASC;INAN
powidło	powidła	NEUT
powiedzenie	powiedzenia	NEUT
powielacz	powielacza	MASC;INAN
powiernictwo	powiernictwa	NEUT
powierzchnia	powierzchni	FEM
powieść	powieści	FEM
powodzianin	powodzianina	MASC;HUM
powojnik	powojnika	MASC;INAN
powrósło	powrósła	NEUT
powrót	powrotu	MASC;INAN
powróz	powrozu	MASC;INAN
powódź	powodzi	FEM
powóz	powozu	MASC;INAN
poza	pozy	FEM
pozdrowienie	pozdrowienia	NEUT
poziewnik	poziewnika	MASC;INAN
poziom	poziomu	MASC;INAN
poziomica	poziomicy	FEM
poziomka	poziomki	FEM
pozyton	pozytonu	MASC;INAN
pozytywka	pozytywki	FEM
pozór	pozoru	MASC;INAN
połowa	połowy	FEM
położenie	położenia	NEUT
położna	położnej	FEM
połóg	połogu	MASC;INAN
pończocha	pończochy	FEM
pościel	pościeli	FEM
pościg	pościgu	MASC;INAN
pośladek	pośladka	MASC;INAN
poświata	poświaty	FEM
poświęcenie	poświęcenia	NEUT
pożar	pożaru	MASC;INAN
pożyczka	pożyczki	FEM
pożytek	pożytku	MASC;INAN
praca	pracy	FEM
pracodawca	pracodawcy	MASC;HUM
pracoholik	pracoholika	MASC;HUM
pracownia	pracowni	FEM
pracownik	pracownika	MASC;HUM
praczka	praczki	FEM
pradziadek	pradziadka	MASC;HUM
praelement	praelementu	MASC;INAN
prajęzyk	prajęzyka	MASC;INAN
praktyka	praktyki	FEM
pralka	pralki	FEM
praporządek	praporządku	MASC;INAN
prasa	prasy	FEM
prawda	prawdy	FEM
prawiczek	prawiczka	MASC;HUM
prawidło	prawidła	NEUT
prawnik	prawnika	MASC;HUM
prawnuczka	prawnuczki	FEM
prawnuk	prawnuka	MASC;HUM
precel	precla	MASC;INAN
prefektura	prefektury	FEM
prefiks	prefiksu	MASC;INAN
premier	premiera	MASC;HUM
premiera	premiery	FEM
prenumerata	prenumeraty	FEM
pretor	pretora	MASC;HUM
prezent	prezentu	MASC;INAN
prezerwatywa	prezerwatywy	FEM
prezydentura	prezydentury	FEM
priv	priva	MASC;INAN
problem	problemu	MASC;INAN
proboszcz	proboszcza	MASC;HUM
proca	procy	FEM
procent	procentu	MASC;INAN
proces	procesu	MASC;INAN
procesor	procesora	MASC;INAN
produkt	produktu	MASC;INAN
program	programu	MASC;INAN
programowanie	programowania	NEUT
projekt	projektu	MASC;INAN
projektant	projektanta	MASC;HUM
prokurator	prokuratora	MASC;HUM
prolina	proliny	FEM
prolog	prologu	MASC;INAN
prom	promu	MASC;INAN
promenada	promenady	FEM
prominent	prominenta	MASC;HUM
propaganda	propagandy	FEM
propan	propanu	MASC;INAN
proporzec	proporca	MASC;INAN
proroctwo	proroctwa	NEUT
prorok	proroka	MASC;HUM
prosiak	prosiaka	MASC;ANIM
prosię	prosięcia	NEUT
prostata	prostaty	FEM
prostopadłościan	prostopadłościanu	MASC;INAN
prostytutka	prostytutki	FEM
proszek	proszku	MASC;INAN
proteina	proteiny	FEM
protektorat	protektoratu	MASC;INAN
protokół	protokołu	MASC;INAN
proton	protonu	MASC;INAN
prowitamina	prowitaminy	FEM
prowodyr	prowodyra	MASC;HUM
prośba	prośby	FEM
prysznic	prysznica	MASC;INAN
prywaciarz	prywaciarza	MASC;HUM
prywatka	prywatki	FEM
przebieralnia	przebieralni	FEM
przechadzka	przechadzki	FEM
przechodzień	przechodnia	MASC;HUM
przecinek	przecinka	MASC;INAN
przeciwciało	przeciwciała	NEUT
przeciwdziedzina	przeciwdziedziny	FEM
przeciwnik	przeciwnika	MASC;HUM
przeciwwaga	przeciwwagi	FEM
przedimek	przedimka	MASC;INAN
przedmiot	przedmiotu	MASC;INAN
przedmowa	przedmowy	FEM
przedramię	przedramienia	NEUT
przedrostek	przedrostka	MASC;INAN
przedsionek	przedsionka	MASC;INAN
przedsiębiorca	przedsiębiorcy	MASC;HUM
przedsiębiorstwo	przedsiębiorstwa	NEUT
przedsięwzięcie	przedsięwzięcia	NEUT
przedstawienie	przedstawienia	NEUT
przeglądarka	przeglądarki	FEM
przejaw	przejawu	MASC;INAN
przejście	przejścia	NEUT
przekaźnik	przekaźnika	MASC;INAN
przekleństwo	przekleństwa	NEUT
przekonanie	przekonania	NEUT
przekrój	przekroju	MASC;INAN
przekątna	przekątnej	FEM
przekład	przekładu	MASC;INAN
przekłamanie	przekłamania	NEUT
przelew	przelewu	MASC;INAN
przemówienie	przemówienia	NEUT
przenośnia	przenośni	FEM
przeobrażenie	przeobrażenia	NEUT
przepaść	przepaści	FEM
przepierka	przepierki	FEM
przepis	przepisu	MASC;INAN
przepiórka	przepiórki	FEM
przeprowadzka	przeprowadzki	FEM
przerwa	przerwy	FEM
przerzutnia	przerzutni	FEM
przesada	przesady	FEM
przesieka	przesieki	FEM
przestroga	przestrogi	FEM
przestrzeń	przestrzeni	FEM
przestępca	przestępcy	MASC;HUM
przestępczość	przestępczości	FEM
przestępstwo	przestępstwa	NEUT
przeszczep	przeszczepu	MASC;INAN
przeszkoda	przeszkody	FEM
przesąd	przesądu	MASC;INAN
przetacznik	przetacznika	MASC;INAN
przetarg	przetargu	MASC;INAN
przetoka	przetoki	FEM
przewaga	przewagi	FEM
przewodniczący	przewodniczącego	MASC;HUM
przewodnik	przewodnika	MASC;HUM
przewrotka	przewrotki	FEM
przewrót	przewrotu	MASC;INAN
przewód	przewodu	MASC;INAN
przeziębienie	przeziębienia	NEUT
przełyk	przełyku	MASC;INAN
przełęcz	przełęczy	FEM
prześcieradło	prześcieradła	NEUT
przeżuwacz	przeżuwacza	MASC;ANIM
przeżytek	przeżytku	MASC;INAN
przodek	przodka	MASC;INAN
przodkini	przodkini	FEM
przybysz	przybysza	MASC;HUM
przychód	przychodu	MASC;INAN
przyczyna	przyczyny	FEM
przydawka	przydawki	FEM
przydomek	przydomka	MASC;INAN
przydupas	przydupasa	MASC;HUM
przygoda	przygody	FEM
przyjaciel	przyjaciela	MASC;HUM
przyjaciółka	przyjaciółki	FEM
przyjemność	przyjemności	FEM
przyjęcie	przyjęcia	NEUT
przylot	przylotu	MASC;INAN
przymierzalnia	przymierzalni	FEM
przymiot	przymiotu	MASC;INAN
przymiotnik	przymiotnika	MASC;INAN
przypadłość	przypadłości	FEM
przypał	przypału	MASC;INAN
przypowieść	przypowieści	FEM
przyprawa	przyprawy	FEM
przypływ	przypływu	MASC;INAN
przyrostek	przyrostka	MASC;INAN
przyrząd	przyrządu	MASC;INAN
przyspieszenie	przyspieszenia	NEUT
przystawka	przystawki	FEM
przysłówek	przysłówka	MASC;INAN
przyzwoitka	przyzwoitki	FEM
przyzwolenie	przyzwolenia	NEUT
przód	przodu	MASC;INAN
przędza	przędzy	FEM
przędziwo	przędziwa	NEUT
przęsło	przęsła	NEUT
próba	próby	FEM
próbówka	próbówki	FEM
próchno	próchna	NEUT
próg	progu	MASC;INAN
próżnia	próżni	FEM
prąd	prądu	MASC;INAN
pręcik	pręcika	MASC;INAN
prędkościomierz	prędkościomierza	MASC;INAN
prędkość	prędkości	FEM
pręgierz	pręgierza	MASC;INAN
pręt	pręta	MASC;INAN
psalm	psalmu	MASC;INAN
psałterz	psałterza	MASC;INAN
pseudonim	pseudonimu	MASC;INAN
psianka	psianki	FEM
psiarnia	psiarni	FEM
psina	psiny	FEM
psisko	psiska	NEUT
pstrąg	pstrąga	MASC;ANIM
psychiatra	psychiatry	MASC;HUM
psychiatryk	psychiatryka	MASC;INAN
psychol	psychola	MASC;ANIM
psycholożka	psycholożki	FEM
psychoterapeutka	psychoterapeutki	FEM
psychuszka	psychuszki	FEM
pszczelarz	pszczelarza	MASC;HUM
pszczoła	pszczoły	FEM
pszczółeczka	pszczółeczki	FEM
pszczółka	pszczółki	FEM
pszono	pszona	NEUT
ptaszysko	ptaszyska	NEUT
puchacz	puchacza	MASC;ANIM
puchar	pucharu	MASC;INAN
puder	pudru	MASC;INAN
pudełko	pudełka	NEUT
pudło	pudła	NEUT
puenta	puenty	FEM
pugilares	pugilaresu	MASC;INAN
pulares	pularesu	MASC;INAN
pulmonolog	pulmonologa	MASC;HUM
pulpet	pulpeta	MASC;INAN
pulsar	pulsara	MASC;INAN
puma	pumy	FEM
pumeks	pumeksu	MASC;INAN
punkt	punktu	MASC;INAN
pupa	pupy	FEM
pustelnik	pustelnika	MASC;HUM
pustka	pustki	FEM
pustułka	pustułki	FEM
pustynia	pustyni	FEM
puszcza	puszczy	FEM
puszczyk	puszczyka	MASC;ANIM
puzon	puzonu	MASC;INAN
pułk	pułku	MASC;INAN
pułkownik	pułkownika	MASC;HUM
pylnik	pylnika	MASC;INAN
pylon	pylonu	MASC;INAN
pyra	pyry	FEM
pysk	pyska	MASC;INAN
pyta	pyty	FEM
pytajnik	pytajnika	MASC;INAN
pytanie	pytania	NEUT
pył	pyłu	MASC;INAN
półeczka	półeczki	FEM
półfinalista	półfinalisty	MASC;HUM
półfinalistka	półfinalistki	FEM
półfinał	półfinału	MASC;INAN
półka	półki	FEM
półkole	półkola	NEUT
półmetal	półmetalu	MASC;INAN
półnuta	półnuty	FEM
półprosta	półprostej	FEM
półprzewodnik	półprzewodnika	MASC;INAN
półrocze	półrocza	NEUT
półtorak	półtoraku	MASC;INAN
półwysep	półwyspu	MASC;INAN
pątnik	pątnika	MASC;HUM
pędzel	pędzla	MASC;INAN
pęknięcie	pęknięcia	NEUT
pępek	pępka	MASC;INAN
pętelka	pętelki	FEM
pętla	pętli	FEM
pęto	pęta	NEUT
płaca	płacy	FEM
płachta	płachty	FEM
płacz	płaczu	MASC;INAN
płaskostopie	płaskostopia	NEUT
płaskowyż	płaskowyżu	MASC;INAN
płaszczka	płaszczki	FEM
płatek	płatka	MASC;INAN
płaziniec	płazińca	MASC;ANIM
płetwa	płetwy	FEM
płetwonurek	płetwonurka	MASC;HUM
płeć	płci	FEM
płomień	płomienia	MASC;INAN
płomykówka	płomykówki	FEM
płot	płotu	MASC;INAN
płotka	płotki	FEM
płoza	płozy	FEM
płoć	płoci	FEM
płuco	płuca	NEUT
pług	pługu	MASC;INAN
pływak	pływaka	MASC;HUM
płód	płodu	MASC;INAN
rabarbar	rabarbaru	MASC;INAN
rabat	rabatu	MASC;INAN
rabin	rabina	MASC;HUM
rabunek	rabunku	MASC;INAN
raca	racy	FEM
rachunek	rachunku	MASC;INAN
rada	rady	FEM
radioamator	radioamatora	MASC;HUM
radioizotop	radioizotopu	MASC;INAN
radiokompas	radiokompasu	MASC;INAN
radiomonter	radiomontera	MASC;HUM
radiowóz	radiowozu	MASC;INAN
radna	radnej	FEM
radny	radnego	MASC;HUM
radło	radła	NEUT
rafandynka	rafandynki	FEM
raj	raju	MASC;INAN
rajdowiec	rajdowca	MASC;HUM
rak	raka	MASC;ANIM
rakieta	rakiety	FEM
rama	ramy	FEM
ramadan	ramadanu	MASC;INAN
ramię	ramienia	NEUT
rana	rany	FEM
randka	randki	FEM
rano	rana	NEUT
raper	rapera	MASC;HUM
raport	raportu	MASC;INAN
rarytas	rarytasu	MASC;INAN
rasista	rasisty	MASC;HUM
rasistka	rasistki	FEM
rata	raty	FEM
raz	razu	MASC;INAN
rdzeń	rdzenia	MASC;INAN
reaktor	reaktora	MASC;INAN
realista	realisty	MASC;HUM
referendum	referendum	NEUT
refren	refrenu	MASC;INAN
regał	regału	MASC;INAN
region	regionu	MASC;INAN
rejs	rejsu	MASC;INAN
reklama	reklamy	FEM
rekord	rekordu	MASC;INAN
rektor	rektora	MASC;HUM
relief	reliefu	MASC;INAN
relikwiarz	relikwiarza	MASC;INAN
remis	remisu	MASC;INAN
rentgen	rentgena	MASC;INAN
replika	repliki	FEM
repozytorium	repozytorium	NEUT
reprezentant	reprezentanta	MASC;HUM
republika	republiki	FEM
reszta	reszty	FEM
resztka	resztki	FEM
rewers	rewersu	MASC;INAN
rewolwer	rewolweru	MASC;INAN
rezultat	rezultatu	MASC;INAN
rezun	rezuna	MASC;HUM
rezus	rezusa	MASC;ANIM
riksza	rikszy	FEM
robocizna	robocizny	FEM
robot	robota	MASC;INAN
robota	roboty	FEM
rodak	rodaka	MASC;HUM
rodzajnik	rodzajnika	MASC;INAN
rodzic	rodzica	MASC;HUM
rodzina	rodziny	FEM
rodzynek	rodzynka	MASC;INAN
rogal	rogala	MASC;INAN
rogalik	rogalika	MASC;INAN
rogówka	rogówki	FEM
rok	roku	MASC;INAN
rokitniczka	rokitniczki	FEM
rola	roli	FEM
rolnik	rolnika	MASC;HUM
romansidło	romansidła	NEUT
romb	rombu	MASC;INAN
rosa	rosy	FEM
rosiczka	rosiczki	FEM
rosjanin	rosjanina	MASC;HUM
rosjanka	rosjanki	FEM
rosomak	rosomaka	MASC;ANIM
roszada	roszady	FEM
roszpunka	roszpunki	FEM
rower	roweru	MASC;INAN
rowerzysta	rowerzysty	MASC;HUM
rowerzystka	rowerzystki	FEM
rozbieżność	rozbieżności	FEM
rozbój	rozboju	MASC;INAN
rozbójnik	rozbójnika	MASC;HUM
rozchodniak	rozchodniaka	MASC;ANIM
rozczarowanie	rozczarowania	NEUT
rozejm	rozejmu	MASC;INAN
rozeta	rozety	FEM
rozgałęźnik	rozgałęźnika	MASC;INAN
rozgrzewka	rozgrzewki	FEM
rozgwiazda	rozgwiazdy	FEM
rozkaz	rozkazu	MASC;INAN
rozkład	rozkładu	MASC;INAN
rozmaitość	rozmaitości	FEM
rozmaryn	rozmarynu	MASC;INAN
rozmiar	rozmiaru	MASC;INAN
rozmowa	rozmowy	FEM
rozpaczanie	rozpaczania	NEUT
rozpierducha	rozpierduchy	FEM
rozprawa	rozprawy	FEM
rozpruwacz	rozpruwacza	MASC;INAN
rozpustnik	rozpustnika	MASC;HUM
rozpuszczalnik	rozpuszczalnika	MASC;INAN
rozruch	rozruchu	MASC;INAN
rozrusznik	rozrusznika	MASC;INAN
rozstrój	rozstroju	MASC;INAN
rozstęp	rozstępu	MASC;INAN
rozszczepienie	rozszczepienia	NEUT
rozsądek	rozsądku	MASC;INAN
rozterka	rozterki	FEM
roztwór	roztworu	MASC;INAN
rozważanie	rozważania	NEUT
rozwidlenie	rozwidlenia	NEUT
rozwodnik	rozwodnika	MASC;HUM
rozwód	rozwodu	MASC;INAN
roślina	rośliny	FEM
roślinka	roślinki	FEM
roślinożerca	roślinożercy	MASC;HUM
rubel	rubla	MASC;ANIM
ruch	ruchu	MASC;INAN
ruczaj	ruczaju	MASC;INAN
ruda	rudy	FEM
rudzik	rudzika	MASC;ANIM
rufa	rufy	FEM
ruja	rui	FEM
ruletka	ruletki	FEM
rum	rumu	MASC;INAN
rumunka	rumunki	FEM
runo	runa	NEUT
rura	rury	FEM
rusek	ruska	MASC;HUM
rybałt	rybałta	MASC;HUM
rybitwa	rybitwy	FEM
rybka	rybki	FEM
rybołów	rybołowa	MASC;ANIM
rycerz	rycerza	MASC;HUM
rycina	ryciny	FEM
ryczałt	ryczałtu	MASC;INAN
rydwan	rydwanu	MASC;INAN
rydz	rydza	MASC;ANIM
ryjówka	ryjówki	FEM
ryk	ryku	MASC;INAN
rym	rymu	MASC;INAN
rynek	rynku	MASC;INAN
rynna	rynny	FEM
rysik	rysika	MASC;INAN
rysunek	rysunku	MASC;INAN
rytm	rytmu	MASC;INAN
rytuał	rytuału	MASC;INAN
ryza	ryzy	FEM
ryzyko	ryzyka	NEUT
rzecznik	rzecznika	MASC;HUM
rzeczownik	rzeczownika	MASC;INAN
rzeczywistość	rzeczywistości	FEM
rzeka	rzeki	FEM
rzemień	rzemienia	MASC;INAN
rzepak	rzepaku	MASC;INAN
rzepik	rzepiku	MASC;INAN
rzeszoto	rzeszota	NEUT
rzeź	rzezi	FEM
rzeźba	rzeźby	FEM
rzeźbiarka	rzeźbiarki	FEM
rzeźnia	rzeźni	FEM
rzeźnik	rzeźnika	MASC;HUM
rzeżucha	rzeżuchy	FEM
rzodkiew	rzodkwi	FEM
rzodkiewka	rzodkiewki	FEM
rzut	rzutu	MASC;INAN
rzutowanie	rzutowania	NEUT
rzęsa	rzęsy	FEM
ród	rodu	MASC;INAN
rówieśnik	rówieśnika	MASC;HUM
równanie	równania	NEUT
równina	równiny	FEM
równoległobok	równoległoboku	MASC;INAN
równoleżnik	równoleżnika	MASC;INAN
równonoc	równonocy	FEM
równoważnik	równoważnika	MASC;INAN
równość	równości	FEM
rózga	rózgi	FEM
róż	różu	MASC;INAN
różaniec	różańca	MASC;INAN
różniczka	różniczki	FEM
różyczka	różyczki	FEM
rączka	rączki	FEM
ręcznik	ręcznika	MASC;INAN
rękaw	rękawa	MASC;INAN
rękawica	rękawicy	FEM
rękawiczka	rękawiczki	FEM
rękodzieło	rękodzieła	NEUT
rękojeść	rękojeści	FEM
sad	sadu	MASC;INAN
sadownik	sadownika	MASC;HUM
sadziec	sadźca	MASC;INAN
sadzonka	sadzonki	FEM
sadło	sadła	NEUT
sakrament	sakramentu	MASC;INAN
saksofon	saksofonu	MASC;INAN
saksofonista	saksofonisty	MASC;HUM
saksofonistka	saksofonistki	FEM
sala	sali	FEM
salamandra	salamandry	FEM
salon	salonu	MASC;INAN
samba	samby	FEM
samica	samicy	FEM
samiec	samca	MASC;ANIM
samobójca	samobójcy	MASC;HUM
samochód	samochodu	MASC;INAN
samogon	samogonu	MASC;INAN
samogłoska	samogłoski	FEM
samouk	samouka	MASC;HUM
samsara	samsary	FEM
saneczkarz	saneczkarza	MASC;HUM
sanitariusz	sanitariusza	MASC;HUM
saracen	saracena	MASC;HUM
sardynka	sardynki	FEM
sarkazm	sarkazmu	MASC;INAN
sarkofag	sarkofagu	MASC;INAN
sarna	sarny	FEM
satanista	satanisty	MASC;HUM
sauna	sauny	FEM
sałata	sałaty	FEM
sałatka	sałatki	FEM
scena	sceny	FEM
scenariusz	scenariusza	MASC;INAN
sceptyk	sceptyka	MASC;HUM
schadzka	schadzki	FEM
schizma	schizmy	FEM
schizofrenik	schizofrenika	MASC;HUM
schorzenie	schorzenia	NEUT
schowek	schowka	MASC;INAN
schronienie	schronienia	NEUT
schronisko	schroniska	NEUT
schyłek	schyłku	MASC;INAN
scyzoryk	scyzoryka	MASC;INAN
sejf	sejfu	MASC;INAN
sejm	sejmu	MASC;INAN
sejmik	sejmiku	MASC;INAN
sejsmometr	sejsmometru	MASC;INAN
sekretarka	sekretarki	FEM
seksta	seksty	FEM
sekta	sekty	FEM
sekunda	sekundy	FEM
selenocysteina	selenocysteiny	FEM
seler	selera	MASC;ANIM
semantyka	semantyki	FEM
semestr	semestru	MASC;INAN
seminarzysta	seminarzysty	MASC;HUM
seminarzystka	seminarzystki	FEM
sen	snu	MASC;INAN
senat	senatu	MASC;INAN
senior	seniora	MASC;HUM
septyma	septymy	FEM
ser	sera	MASC;INAN
serb	serba	MASC;HUM
serce	serca	NEUT
serduszko	serduszka	NEUT
sernik	sernika	MASC;INAN
serwatka	serwatki	FEM
serwerownia	serwerowni	FEM
serwetka	serwetki	FEM
serwis	serwisu	MASC;INAN
seryna	seryny	FEM
seskwiterpen	seskwiterpenu	MASC;INAN
seta	sety	FEM
sezon	sezonu	MASC;INAN
sfinks	sfinksa	MASC;ANIM
shogun	shoguna	MASC;HUM
siad	siadu	MASC;INAN
siarczek	siarczku	MASC;INAN
siarczyn	siarczynu	MASC;INAN
siatka	siatki	FEM
siatkarz	siatkarza	MASC;HUM
siatkówka	siatkówki	FEM
sidło	sidła	NEUT
siedmiokąt	siedmiokąta	MASC;INAN
siedziba	siedziby	FEM
siejba	siejby	FEM
siekacz	siekacza	MASC;INAN
siemens	siemensa	MASC;INAN
siemię	siemienia	NEUT
sierociniec	sierocińca	MASC;INAN
sieroctwo	sieroctwa	NEUT
sierp	sierpa	MASC;INAN
sierpień	sierpnia	MASC;INAN
sierść	sierści	FEM
siew	siewu	MASC;INAN
siewca	siewcy	MASC;HUM
siewnik	siewnika	MASC;INAN
sieć	sieci	FEM
siksa	siksy	FEM
silnia	silni	FEM
silnik	silnika	MASC;INAN
simens	simensa	MASC;INAN
siniak	siniaka	MASC;INAN
sinica	sinicy	FEM
siniec	sińca	MASC;INAN
sinus	sinusa	MASC;INAN
siodełko	siodełka	NEUT
siogun	sioguna	MASC;HUM
siostra	siostry	FEM
siostrzenica	siostrzenicy	FEM
siostrzeniec	siostrzeńca	MASC;HUM
sioło	sioła	NEUT
sitko	sitka	NEUT
sito	sita	NEUT
siusiak	siusiaka	MASC;ANIM
siwert	siwerta	MASC;INAN
siódemka	siódemki	FEM
siła	siły	FEM
siłacz	siłacza	MASC;HUM
siłownia	siłowni	FEM
skalnica	skalnicy	FEM
skamielina	skamieliny	FEM
skamieniałość	skamieniałości	FEM
skarbiec	skarbca	MASC;INAN
skarbnica	skarbnicy	FEM
skarbnik	skarbnika	MASC;HUM
skarbonka	skarbonki	FEM
skarga	skargi	FEM
skarpeta	skarpety	FEM
skarpetka	skarpetki	FEM
skaza	skazy	FEM
skazaniec	skazańca	MASC;HUM
skałoczep	skałoczepa	MASC;ANIM
skałotocz	skałotocza	MASC;ANIM
sklejka	sklejki	FEM
sklep	sklepu	MASC;INAN
sklepienie	sklepienia	NEUT
skok	skoku	MASC;INAN
skon	skonu	MASC;INAN
skrawek	skrawka	MASC;INAN
skrobak	skrobaka	MASC;INAN
skrobanka	skrobanki	FEM
skrobia	skrobi	FEM
skroń	skroni	FEM
skrypt	skryptu	MASC;INAN
skrzat	skrzata	MASC;ANIM
skrzele	skrzela	NEUT
skrzydełko	skrzydełka	NEUT
skrzydlak	skrzydlaka	MASC;INAN
skrzydlica	skrzydlicy	FEM
skrzydlik	skrzydlika	MASC;INAN
skrzydło	skrzydła	NEUT
skrzydłowy	skrzydłowego	MASC;HUM
skrzydłówka	skrzydłówki	FEM
skrzynia	skrzyni	FEM
skrzynka	skrzynki	FEM
skrzypaczka	skrzypaczki	FEM
skrzyżowanie	skrzyżowania	NEUT
skrót	skrótu	MASC;INAN
skrótowiec	skrótowca	MASC;INAN
skunks	skunksa	MASC;ANIM
skurwysyn	skurwysyna	MASC;HUM
skuter	skutera	MASC;INAN
skóra	skóry	FEM
skąpiec	skąpca	MASC;HUM
skład	składu	MASC;INAN
składnik	składnika	MASC;INAN
skłonność	skłonności	FEM
skłot	skłotu	MASC;INAN
slogan	sloganu	MASC;INAN
slup	slupu	MASC;INAN
smak	smaku	MASC;INAN
smar	smaru	MASC;INAN
smerf	smerfa	MASC;ANIM
smoczek	smoczka	MASC;INAN
smok	smoka	MASC;ANIM
smoking	smokingu	MASC;INAN
smolarz	smolarza	MASC;HUM
smoła	smoły	FEM
smród	smrodu	MASC;INAN
smuga	smugi	FEM
smycz	smyczy	FEM
smyk	smyka	MASC;HUM
snooker	snookera	MASC;INAN
snycerz	snycerza	MASC;HUM
sobota	soboty	FEM
sobowtór	sobowtóra	MASC;HUM
socjalista	socjalisty	MASC;HUM
socynianin	socynianina	MASC;HUM
soczewica	soczewicy	FEM
soczewka	soczewki	FEM
sodomita	sodomity	MASC;HUM
sokół	sokoła	MASC;ANIM
sola	soli	FEM
solanka	solanki	FEM
solarium	solarium	NEUT
solniczka	solniczki	FEM
sos	sosu	MASC;INAN
sołectwo	sołectwa	NEUT
spacer	spaceru	MASC;INAN
spacerniak	spacerniaka	MASC;INAN
spadek	spadku	MASC;INAN
spadochron	spadochronu	MASC;INAN
spawacz	spawacza	MASC;HUM
spawarka	spawarki	FEM
spektrometr	spektrometru	MASC;INAN
spektroskop	spektroskopu	MASC;INAN
spektrum	spektrum	NEUT
spekulant	spekulanta	MASC;HUM
spierdolina	spierdoliny	FEM
spierdon	spierdona	MASC;ANIM
spin	spinu	MASC;INAN
spinka	spinki	FEM
spirodela	spirodeli	FEM
spirometr	spirometru	MASC;INAN
spisek	spisku	MASC;INAN
spięcie	spięcia	NEUT
spoiwo	spoiwa	NEUT
spojrzenie	spojrzenia	NEUT
spojówka	spojówki	FEM
sport	sportu	MASC;INAN
sportowiec	sportowca	MASC;HUM
sposób	sposobu	MASC;INAN
spotkanie	spotkania	NEUT
spowiednik	spowiednika	MASC;HUM
spowiedź	spowiedzi	FEM
społeczeństwo	społeczeństwa	NEUT
sprawdzian	sprawdzianu	MASC;INAN
sprzeciw	sprzeciwu	MASC;INAN
sprzedawczyni	sprzedawczyni	FEM
sprzedaż	sprzedaży	FEM
sprzątacz	sprzątacza	MASC;HUM
sprzątaczka	sprzątaczki	FEM
sprzęgło	sprzęgła	NEUT
sprzęt	sprzętu	MASC;INAN
spust	spustu	MASC;INAN
spód	spodu	MASC;INAN
spódnica	spódnicy	FEM
spór	sporu	MASC;INAN
spółgłoska	spółgłoski	FEM
spłonka	spłonki	FEM
sracz	sracza	MASC;INAN
sraczka	sraczki	FEM
sreberko	sreberka	NEUT
srebrny	srebrnego	MASC;INAN
srom	sromu	MASC;INAN
ssak	ssaka	MASC;ANIM
stadion	stadionu	MASC;INAN
stadium	stadium	NEUT
stado	stada	NEUT
stadło	stadła	NEUT
stal	stali	FEM
stalagmit	stalagmitu	MASC;INAN
stalówka	stalówki	FEM
stan	stanu	MASC;INAN
standard	standardu	MASC;INAN
stanowisko	stanowiska	NEUT
starosta	starosty	MASC;HUM
start	startu	MASC;INAN
starzec	starca	MASC;HUM
statek	statku	MASC;INAN
statysta	statysty	MASC;HUM
statystyk	statystyka	MASC;HUM
statystyka	statystyki	FEM
statyw	statywu	MASC;INAN
staw	stawu	MASC;INAN
stawonóg	stawonoga	MASC;ANIM
stała	stałej	FEM
stek	steku	MASC;INAN
stenograf	stenografa	MASC;HUM
stenografka	stenografki	FEM
stenogram	stenogramu	MASC;INAN
step	stepu	MASC;INAN
ster	steru	MASC;INAN
steradian	steradiana	MASC;INAN
sterburta	sterburty	FEM
sterowiec	sterowca	MASC;INAN
sterownik	sterownika	MASC;INAN
sterta	sterty	FEM
stetoskop	stetoskopu	MASC;INAN
stewardessa	stewardessy	FEM
stocznia	stoczni	FEM
stoisko	stoiska	NEUT
stokrotka	stokrotki	FEM
stolec	stolca	MASC;INAN
stolica	stolicy	FEM
stoliczek	stoliczka	MASC;INAN
stolik	stolika	MASC;INAN
stolnica	stolnicy	FEM
stomatolog	stomatologa	MASC;HUM
stonoga	stonogi	FEM
stop	stopu	MASC;INAN
stopa	stopy	FEM
storczyk	storczyka	MASC;INAN
stos	stosu	MASC;INAN
stołek	stołka	MASC;INAN
stożek	stożka	MASC;INAN
strach	strachu	MASC;INAN
stragan	straganu	MASC;INAN
straszydło	straszydła	NEUT
strateg	stratega	MASC;HUM
stratosfera	stratosfery	FEM
straż	straży	FEM
strażak	strażaka	MASC;HUM
strażnica	strażnicy	FEM
strażnik	strażnika	MASC;HUM
strefa	strefy	FEM
stres	stresu	MASC;INAN
strit	strita	MASC;ANIM
stroboskop	stroboskopu	MASC;INAN
strofa	strofy	FEM
stroik	stroika	MASC;INAN
strona	strony	FEM
strop	stropu	MASC;INAN
strug	struga	MASC;INAN
struga	strugi	FEM
struktura	struktury	FEM
strumień	strumienia	MASC;INAN
strumyk	strumyka	MASC;INAN
struna	struny	FEM
struś	strusia	MASC;ANIM
strych	strychu	MASC;INAN
stryj	stryja	MASC;HUM
strzał	strzału	MASC;INAN
strzałka	strzałki	FEM
strzelanie	strzelania	NEUT
strzelba	strzelby	FEM
strzelec	strzelca	MASC;HUM
strzeliwo	strzeliwa	NEUT
strzelnica	strzelnicy	FEM
strzemienny	strzemiennego	MASC;ANIM
strzemię	strzemienia	NEUT
strzykawka	strzykawki	FEM
strzyżyk	strzyżyka	MASC;ANIM
strzęp	strzępu	MASC;INAN
strąk	strąka	MASC;INAN
stręczyciel	stręczyciela	MASC;HUM
student	studenta	MASC;HUM
studentka	studentki	FEM
studniówka	studniówki	FEM
stulecie	stulecia	NEUT
stułbia	stułbi	FEM
stwardnienie	stwardnienia	NEUT
stwierdzenie	stwierdzenia	NEUT
stwór	stwora	MASC;ANIM
styl	stylu	MASC;INAN
stypendium	stypendium	NEUT
stóg	stogu	MASC;INAN
stół	stołu	MASC;INAN
stągiew	stągwi	FEM
stłuczka	stłuczki	FEM
suchar	suchara	MASC;INAN
sucz	suczy	FEM
sufler	suflera	MASC;HUM
sukieneczka	sukieneczki	FEM
sukienka	sukienki	FEM
sukinsyn	sukinsyna	MASC;HUM
suknia	sukni	FEM
sum	suma	MASC;ANIM
suma	sumy	FEM
sumienie	sumienia	NEUT
superkomputer	superkomputera	MASC;INAN
supermarket	supermarketu	MASC;INAN
supernowa	supernowej	FEM
supeł	supła	MASC;INAN
sura	sury	FEM
surdut	surdutu	MASC;INAN
surowica	surowicy	FEM
surowiec	surowca	MASC;INAN
surówka	surówki	FEM
suseł	susła	MASC;ANIM
susza	suszy	FEM
suszarka	suszarki	FEM
sutener	sutenera	MASC;HUM
suw	suwu	MASC;INAN
suwnica	suwnicy	FEM
sułtan	sułtana	MASC;HUM
swat	swata	MASC;HUM
sweter	swetra	MASC;INAN
swoboda	swobody	FEM
syf	syfu	MASC;INAN
sylaba	sylaby	FEM
sylwester	sylwestra	MASC;ANIM
sylwetka	sylwetki	FEM
symptom	symptomu	MASC;INAN
syn	syna	MASC;HUM
synagoga	synagogi	FEM
synonim	synonimu	MASC;INAN
synowa	synowej	FEM
syrena	syreny	FEM
syrop	syropu	MASC;INAN
system	systemu	MASC;INAN
szabas	szabasu	MASC;INAN
szablodziób	szablodzioba	MASC;ANIM
szablon	szablonu	MASC;INAN
szabrownik	szabrownika	MASC;HUM
szachista	szachisty	MASC;HUM
szachistka	szachistki	FEM
szacunek	szacunku	MASC;INAN
szafa	szafy	FEM
szafeczka	szafeczki	FEM
szafiarka	szafiarki	FEM
szajba	szajby	FEM
szajs	szajsu	MASC;INAN
szakal	szakala	MASC;ANIM
szalet	szaletu	MASC;INAN
szaman	szamana	MASC;HUM
szampan	szampanu	MASC;INAN
szampon	szamponu	MASC;INAN
szansa	szansy	FEM
szanta	szanty	FEM
szantażysta	szantażysty	MASC;HUM
szarada	szarady	FEM
szarańcza	szarańczy	FEM
szariat	szariatu	MASC;INAN
szarówka	szarówki	FEM
szaszłyk	szaszłyka	MASC;INAN
szata	szaty	FEM
szatnia	szatni	FEM
szałamaja	szałamai	FEM
szczawik	szczawiku	MASC;INAN
szczegół	szczegółu	MASC;INAN
szczelina	szczeliny	FEM
szczeniak	szczeniaka	MASC;HUM
szczepienie	szczepienia	NEUT
szczepionka	szczepionki	FEM
szczoteczka	szczoteczki	FEM
szczudło	szczudła	NEUT
szczurzyca	szczurzycy	FEM
szczwół	szczwołu	MASC;INAN
szczygieł	szczygła	MASC;ANIM
szczypior	szczypioru	MASC;INAN
szczypiornista	szczypiornisty	MASC;HUM
szczypta	szczypty	FEM
szczyt	szczytu	MASC;INAN
szczęka	szczęki	FEM
szef	szefa	MASC;HUM
szelka	szelki	FEM
szelężnik	szelężnika	MASC;INAN
szept	szeptu	MASC;INAN
szereg	szeregu	MASC;INAN
szermierz	szermierza	MASC;HUM
szerokość	szerokości	FEM
szerszeń	szerszenia	MASC;ANIM
szewc	szewca	MASC;HUM
sześcian	sześcianu	MASC;INAN
szkapa	szkapy	FEM
szkatuła	szkatuły	FEM
szkielet	szkieletu	MASC;INAN
szklanka	szklanki	FEM
szklarnia	szklarni	FEM
szkliwo	szkliwa	NEUT
szkocka	szkockiej	FEM
szkoda	szkody	FEM
szkodnik	szkodnika	MASC;ANIM
szkopuł	szkopułu	MASC;INAN
szkot	szkota	MASC;HUM
szkoła	szkoły	FEM
szkuner	szkunera	MASC;INAN
szkutnik	szkutnika	MASC;HUM
szkwał	szkwału	MASC;INAN
szkło	szkła	NEUT
szlachar	szlachara	MASC;ANIM
szlachcianka	szlachcianki	FEM
szlachcic	szlachcica	MASC;HUM
szlachta	szlachty	FEM
szlafrok	szlafroka	MASC;INAN
szlak	szlaku	MASC;INAN
szlaka	szlaki	FEM
szlauch	szlaucha	MASC;INAN
szlug	szluga	MASC;ANIM
szmalcownik	szmalcownika	MASC;HUM
szmaragd	szmaragdu	MASC;INAN
szmata	szmaty	FEM
szmugler	szmuglera	MASC;HUM
sznurek	sznurka	MASC;INAN
sznurowadło	sznurowadła	NEUT
szogun	szoguna	MASC;HUM
szop	szopa	MASC;ANIM
szopa	szopy	FEM
szpadel	szpadla	MASC;INAN
szpak	szpaka	MASC;ANIM
szpara	szpary	FEM
szpieg	szpiega	MASC;HUM
szpinak	szpinaku	MASC;INAN
szpital	szpitala	MASC;INAN
szprot	szprota	MASC;ANIM
szprycha	szprychy	FEM
szpula	szpuli	FEM
szrot	szrotu	MASC;INAN
sztacheta	sztachety	FEM
sztandar	sztandaru	MASC;INAN
sztorm	sztormu	MASC;INAN
sztuka	sztuki	FEM
szturm	szturmu	MASC;INAN
szubienica	szubienicy	FEM
szubrawca	szubrawcy	MASC;HUM
szuflada	szuflady	FEM
szuler	szulera	MASC;HUM
szum	szumu	MASC;INAN
szwab	szwaba	MASC;HUM
szwagier	szwagra	MASC;HUM
szwagierka	szwagierki	FEM
szwajcar	szwajcara	MASC;HUM
szwedka	szwedki	FEM
szyba	szyby	FEM
szyberdach	szyberdachu	MASC;INAN
szybkość	szybkości	FEM
szybowiec	szybowca	MASC;INAN
szydło	szydła	NEUT
szyfrowanie	szyfrowania	NEUT
szyja	szyi	FEM
szyk	szyku	MASC;INAN
szympans	szympansa	MASC;ANIM
szynka	szynki	FEM
szynszyla	szynszyli	FEM
szyszka	szyszki	FEM
szyszynka	szyszynki	FEM
sójka	sójki	FEM
sól	soli	FEM
sóweczka	sóweczki	FEM
sąd	sądu	MASC;INAN
sąsiad	sąsiada	MASC;HUM
sąsiadka	sąsiadki	FEM
sędzina	sędziny	FEM
sęk	sęku	MASC;INAN
słabość	słabości	FEM
sława	sławy	FEM
sławojka	sławojki	FEM
słodycz	słodyczy	FEM
słodzik	słodzika	MASC;INAN
słoiczek	słoiczka	MASC;INAN
słoneczko	słoneczka	NEUT
słonica	słonicy	FEM
słonka	słonki	FEM
słonko	słonka	NEUT
słota	słoty	FEM
słowak	słowaka	MASC;HUM
słoweniec	słoweńca	MASC;HUM
słowenka	słowenki	FEM
słowianin	słowianina	MASC;HUM
słownik	słownika	MASC;INAN
słowo	słowa	NEUT
słoń	słonia	MASC;ANIM
słońce	słońca	NEUT
słuchawka	słuchawki	FEM
sługus	sługusa	MASC;HUM
słup	słupa	MASC;ANIM
słupek	słupka	MASC;INAN
służba	służby	FEM
służąca	służącej	FEM
służący	służącego	MASC;HUM
słód	słodu	MASC;INAN
tabela	tabeli	FEM
tabernakulum	tabernakulum	NEUT
tablica	tablicy	FEM
tabliczka	tabliczki	FEM
tabloid	tabloidu	MASC;INAN
tabor	taboru	MASC;INAN
taboret	taboretu	MASC;INAN
taca	tacy	FEM
tajemnica	tajemnicy	FEM
tajfun	tajfunu	MASC;INAN
tajga	tajgi	FEM
taksówkarz	taksówkarza	MASC;HUM
talerz	talerza	MASC;INAN
talizman	talizmanu	MASC;INAN
talon	talonu	MASC;INAN
tama	tamy	FEM
tampon	tamponu	MASC;INAN
tanatopraksja	tanatopraksji	FEM
tandeta	tandety	FEM
tanina	taniny	FEM
tankowiec	tankowca	MASC;INAN
tapczan	tapczanu	MASC;INAN
tapeta	tapety	FEM
taraban	tarabanu	MASC;INAN
taras	tarasu	MASC;INAN
tarcza	tarczy	FEM
tarczyca	tarczycy	FEM
targ	targu	MASC;INAN
tarka	tarki	FEM
tartak	tartaku	MASC;INAN
tasak	tasaka	MASC;INAN
tasza	taszy	FEM
tasznik	tasznika	MASC;INAN
tatar	tatara	MASC;INAN
taternik	taternika	MASC;HUM
tatuś	tatusia	MASC;HUM
technik	technika	MASC;HUM
technika	techniki	FEM
teczka	teczki	FEM
teista	teisty	MASC;HUM
tekst	tekstu	MASC;INAN
telefon	telefonu	MASC;INAN
telefonistka	telefonistki	FEM
telegraf	telegrafu	MASC;INAN
telegram	telegramu	MASC;INAN
telenowela	telenoweli	FEM
telewizor	telewizora	MASC;INAN
temat	tematu	MASC;INAN
temblak	temblaka	MASC;INAN
temperatura	temperatury	FEM
temperówka	temperówki	FEM
tempo	tempa	NEUT
tempomat	tempomatu	MASC;INAN
tender	tendra	MASC;INAN
tenisista	tenisisty	MASC;HUM
tenisistka	tenisistki	FEM
tenisówka	tenisówki	FEM
teodolit	teodolitu	MASC;INAN
terapeuta	terapeuty	MASC;HUM
teren	terenu	MASC;INAN
terkotka	terkotki	FEM
termin	terminu	MASC;INAN
termometr	termometru	MASC;INAN
termos	termosu	MASC;INAN
termosfera	termosfery	FEM
termostat	termostatu	MASC;INAN
terrorysta	terrorysty	MASC;HUM
terytorium	terytorium	NEUT
testament	testamentu	MASC;INAN
teściowa	teściowej	FEM
teść	teścia	MASC;HUM
tilaka	tilaki	FEM
tir	tira	MASC;ANIM
tirówka	tirówki	FEM
tkacz	tkacza	MASC;HUM
tkaczka	tkaczki	FEM
tkanka	tkanki	FEM
tlenek	tlenku	MASC;INAN
toast	toastu	MASC;INAN
tojad	tojadu	MASC;INAN
tok	toku	MASC;INAN
toluen	toluenu	MASC;INAN
ton	tonu	MASC;INAN
tona	tony	FEM
tonsura	tonsury	FEM
topaz	topazu	MASC;INAN
topnik	topnika	MASC;INAN
topograf	topografa	MASC;HUM
topola	topoli	FEM
toponim	toponimu	MASC;INAN
toporek	toporka	MASC;INAN
topór	topora	MASC;INAN
torba	torby	FEM
toster	tostera	MASC;INAN
towar	towaru	MASC;INAN
towarzystwo	towarzystwa	NEUT
toyota	toyoty	FEM
tożsamość	tożsamości	FEM
traganek	traganka	MASC;INAN
tragarz	tragarza	MASC;HUM
transformator	transformatora	MASC;INAN
transparent	transparentu	MASC;INAN
transseksualista	transseksualisty	MASC;HUM
tranzystor	tranzystora	MASC;INAN
trapez	trapezu	MASC;INAN
trasownik	trasownika	MASC;INAN
traszka	traszki	FEM
tratwa	tratwy	FEM
trawa	trawy	FEM
trawnik	trawnika	MASC;INAN
trefl	trefla	MASC;ANIM
tren	trenu	MASC;INAN
treonina	treoniny	FEM
treść	treści	FEM
trolejbus	trolejbusu	MASC;INAN
tropik	tropiku	MASC;INAN
troposfera	troposfery	FEM
troska	troski	FEM
truchło	truchła	NEUT
trucizna	trucizny	FEM
trud	trudu	MASC;INAN
trufla	trufli	FEM
trumna	trumny	FEM
trunek	trunku	MASC;INAN
trup	trupa	MASC;ANIM
truskaweczka	truskaweczki	FEM
truteń	trutnia	MASC;ANIM
tryb	trybu	MASC;INAN
tryk	tryka	MASC;ANIM
trzcina	trzciny	FEM
trzepak	trzepaka	MASC;INAN
trzepot	trzepotu	MASC;INAN
trzmiel	trzmiela	MASC;ANIM
trzon	trzonu	MASC;INAN
trzonowiec	trzonowca	MASC;INAN
trzustka	trzustki	FEM
trzykrotka	trzykrotki	FEM
trójeczka	trójeczki	FEM
trójka	trójki	FEM
trójkąt	trójkąta	MASC;INAN
trójząb	trójzębu	MASC;INAN
trąba	trąby	FEM
trąbka	trąbki	FEM
trębacz	trębacza	MASC;HUM
tukan	tukana	MASC;ANIM
tuleja	tulei	FEM
tulipanowiec	tulipanowca	MASC;INAN
tundra	tundry	FEM
tunel	tunelu	MASC;INAN
tur	tura	MASC;ANIM
turas	turasa	MASC;HUM
turban	turbanu	MASC;INAN
turczynka	turczynki	FEM
turek	turka	MASC;HUM
turkawka	turkawki	FEM
turkmenka	turkmenki	FEM
turkus	turkusu	MASC;INAN
turniej	turnieju	MASC;INAN
turysta	turysty	MASC;HUM
turystka	turystki	FEM
turzyca	turzycy	FEM
tusz	tuszu	MASC;INAN
tusza	tuszy	FEM
tuz	tuza	MASC;ANIM
tułacz	tułacza	MASC;HUM
tułów	tułowia	MASC;INAN
tuńczyk	tuńczyka	MASC;ANIM
twardość	twardości	FEM
twardówka	twardówki	FEM
twarz	twarzy	FEM
twaróg	twarogu	MASC;INAN
twierdzenie	twierdzenia	NEUT
twór	tworu	MASC;INAN
twórca	twórcy	MASC;HUM
tygiel	tygla	MASC;INAN
tygrysica	tygrysicy	FEM
tylda	tyldy	FEM
tymianek	tymianku	MASC;INAN
tyranozaur	tyranozaura	MASC;ANIM
tyrozyna	tyrozyny	FEM
tytuł	tytułu	MASC;INAN
tył	tyłu	MASC;INAN
tyłek	tyłka	MASC;INAN
tęczówka	tęczówki	FEM
tęsknota	tęsknoty	FEM
tło	tła	NEUT
tłuczek	tłuczka	MASC;INAN
tłum	tłumu	MASC;INAN
tłumik	tłumika	MASC;INAN
tłuszcz	tłuszczu	MASC;INAN
uaktywnianie	uaktywniania	NEUT
ubaw	ubawu	MASC;INAN
ubranie	ubrania	NEUT
uchodźca	uchodźcy	MASC;HUM
uchwyt	uchwytu	MASC;INAN
uciekinier	uciekiniera	MASC;HUM
ucieleśnienie	ucieleśnienia	NEUT
uczelnia	uczelni	FEM
uczennica	uczennicy	FEM
uczeń	ucznia	MASC;HUM
uczony	uczonego	MASC;HUM
uczta	uczty	FEM
uczucie	uczucia	NEUT
uczulenie	uczulenia	NEUT
uczynek	uczynku	MASC;INAN
udar	udaru	MASC;INAN
uderzenie	uderzenia	NEUT
udko	udka	NEUT
udo	uda	NEUT
udręka	udręki	FEM
układ	układu	MASC;INAN
ulewa	ulewy	FEM
ulga	ulgi	FEM
ulotka	ulotki	FEM
ultramaryna	ultramaryny	FEM
umiejętność	umiejętności	FEM
umowa	umowy	FEM
umysł	umysłu	MASC;INAN
umywalka	umywalki	FEM
undekan	undekanu	MASC;INAN
uniform	uniformu	MASC;INAN
unik	uniku	MASC;INAN
uosobienie	uosobienia	NEUT
upadek	upadku	MASC;INAN
upał	upału	MASC;INAN
upgrade	upgrade'u	MASC;INAN
upokorzenie	upokorzenia	NEUT
upośledzenie	upośledzenia	NEUT
uprawa	uprawy	FEM
uprowadzenie	uprowadzenia	NEUT
uprzedzenie	uprzedzenia	NEUT
uraninit	uraninitu	MASC;INAN
urdzik	urdzika	MASC;INAN
urna	urny	FEM
urodzenie	urodzenia	NEUT
urok	uroku	MASC;INAN
urolog	urologa	FEM
urząd	urzędu	MASC;INAN
urządzenie	urządzenia	NEUT
urzędas	urzędasa	MASC;HUM
urzędnik	urzędnika	MASC;HUM
usposobienie	usposobienia	NEUT
ustawa	ustawy	FEM
ustawka	ustawki	FEM
usterka	usterki	FEM
ustnik	ustnika	MASC;INAN
ustrojstwo	ustrojstwa	NEUT
ustępstwo	ustępstwa	NEUT
uszczerbek	uszczerbku	MASC;INAN
usługa	usługi	FEM
utwór	utworu	MASC;INAN
uwaga	uwagi	FEM
uwodziciel	uwodziciela	MASC;HUM
uzasadnienie	uzasadnienia	NEUT
uzda	uzdy	FEM
uzus	uzusu	MASC;INAN
uśmiech	uśmiechu	MASC;INAN
użyszkodnik	użyszkodnika	MASC;HUM
użytkownik	użytkownika	MASC;HUM
wachlarz	wachlarza	MASC;INAN
wachta	wachty	FEM
wadera	wadery	FEM
wafel	wafla	MASC;INAN
wafelek	wafelka	MASC;INAN
wagon	wagonu	MASC;INAN
wahadło	wahadła	NEUT
wahadłowiec	wahadłowca	MASC;INAN
wahanie	wahania	NEUT
wajcha	wajchy	FEM
waldek	waldka	MASC;HUM
walec	walca	MASC;INAN
walina	waliny	FEM
walizka	walizki	FEM
walka	walki	FEM
waluta	waluty	FEM
wandal	wandala	MASC;HUM
wandalizm	wandalizmu	MASC;INAN
wanna	wanny	FEM
wapień	wapienia	MASC;INAN
waran	warana	MASC;ANIM
warchlak	warchlaka	MASC;ANIM
wariat	wariata	MASC;HUM
warownia	warowni	FEM
warszawa	warszawy	FEM
warszawiak	warszawiaka	MASC;HUM
warszawianka	warszawianki	FEM
warsztat	warsztatu	MASC;INAN
warunek	warunku	MASC;INAN
warzucha	warzuchy	FEM
warzywo	warzywa	NEUT
wasal	wasala	MASC;HUM
waszmość	waszmości	FEM
wat	wata	MASC;INAN
wataha	watahy	FEM
wawrzyn	wawrzynu	MASC;INAN
wazon	wazonu	MASC;INAN
waćpan	waćpana	MASC;HUM
wałach	wałacha	MASC;ANIM
wałówka	wałówki	FEM
waść	waści	FEM
ważka	ważki	FEM
ważniak	ważniaka	MASC;HUM
wdech	wdechu	MASC;INAN
wdowa	wdowy	FEM
weber	webera	MASC;INAN
weekend	weekendu	MASC;INAN
wegetarianin	wegetarianina	MASC;HUM
wejście	wejścia	NEUT
wektor	wektora	MASC;INAN
wentylator	wentylatora	MASC;INAN
weranda	werandy	FEM
werbel	werbla	MASC;INAN
werbena	werbeny	FEM
werbunek	werbunku	MASC;INAN
wers	wersu	MASC;INAN
werset	wersetu	MASC;INAN
wesele	wesela	NEUT
westchnienie	westchnienia	NEUT
western	westernu	MASC;INAN
wezyr	wezyra	MASC;HUM
wełna	wełny	FEM
wiadomość	wiadomości	FEM
wiadro	wiadra	NEUT
wiadukt	wiaduktu	MASC;INAN
wianek	wianka	MASC;INAN
wiarołomca	wiarołomcy	MASC;HUM
wiaterek	wiaterka	MASC;INAN
wiatr	wiatru	MASC;INAN
wiatrak	wiatraka	MASC;INAN
wibrafon	wibrafonu	MASC;INAN
wibrator	wibratora	MASC;INAN
wicher	wichru	MASC;INAN
wichura	wichury	FEM
wiciokrzew	wiciokrzewu	MASC;INAN
widelczyk	widelczyka	MASC;INAN
widelec	widelca	MASC;INAN
widmo	widma	NEUT
widnokrąg	widnokręgu	MASC;INAN
widok	widoku	MASC;INAN
widowisko	widowiska	NEUT
widownia	widowni	FEM
widz	widza	MASC;HUM
widzenie	widzenia	NEUT
widziadło	widziadła	NEUT
wiecheć	wiechcia	MASC;INAN
wieczerza	wieczerzy	FEM
wiedźma	wiedźmy	FEM
wiejadło	wiejadła	NEUT
wiek	wieku	MASC;INAN
wieko	wieka	NEUT
wielbłąd	wielbłąda	MASC;ANIM
wielkość	wielkości	FEM
wielobok	wieloboku	MASC;INAN
wielokropek	wielokropka	MASC;INAN
wielokąt	wielokątu	MASC;INAN
wielomian	wielomianu	MASC;INAN
wieloryb	wieloryba	MASC;ANIM
wielościan	wielościanu	MASC;INAN
wieniec	wieńca	MASC;INAN
wierchuszka	wierchuszki	FEM
wierność	wierności	FEM
wierny	wiernego	MASC;HUM
wiersz	wiersza	MASC;INAN
wiersza	wierszy	FEM
wiertło	wiertła	NEUT
wierzba	wierzby	FEM
wierzchowiec	wierzchowca	MASC;ANIM
wierzchołek	wierzchołka	MASC;INAN
wierzyciel	wierzyciela	MASC;HUM
wierzący	wierzącego	MASC;HUM
wiesiołek	wiesiołka	MASC;INAN
wieszak	wieszaka	MASC;INAN
wieszczyk	wieszczyka	MASC;ANIM
wietnamczyk	wietnamczyka	MASC;HUM
wietnamiec	wietnamca	MASC;HUM
wiewiórka	wiewiórki	FEM
wieś	wsi	FEM
wieśniak	wieśniaka	MASC;HUM
wieść	wieści	FEM
wieża	wieży	FEM
wieżowiec	wieżowca	MASC;INAN
wigwam	wigwamu	MASC;INAN
wihajster	wihajstra	MASC;INAN
wikipedysta	wikipedysty	MASC;HUM
wikt	wiktu	MASC;INAN
wikłacz	wikłacza	MASC;ANIM
wilczyca	wilczycy	FEM
wilk	wilka	MASC;ANIM
wilkołak	wilkołaka	MASC;ANIM
wilżyna	wilżyny	FEM
winda	windy	FEM
winnica	winnicy	FEM
wino	wina	NEUT
winogrono	winogrona	NEUT
winorośl	winorośli	FEM
wiocha	wiochy	FEM
wiolonczela	wiolonczeli	FEM
wiorsta	wiorsty	FEM
wioska	wioski	FEM
wiosna	wiosny	FEM
wiosło	wiosła	NEUT
wir	wiru	MASC;INAN
wirnik	wirnika	MASC;INAN
wirus	wirusa	MASC;ANIM
wisienka	wisienki	FEM
witamina	witaminy	FEM
wiza	wizy	FEM
wizyta	wizyty	FEM
wizytówka	wizytówki	FEM
wiąz	wiązu	MASC;INAN
wiązka	wiązki	FEM
wiązówka	wiązówki	FEM
wić	wici	FEM
większość	większości	FEM
więzadło	więzadła	NEUT
więzienie	więzienia	NEUT
więzień	więźnia	MASC;HUM
więź	więzi	FEM
wiła	wiły	FEM
wiśnia	wiśni	FEM
wjazd	wjazdu	MASC;INAN
wniosek	wniosku	MASC;INAN
wnuczek	wnuczka	MASC;HUM
wnuczę	wnuczęcia	NEUT
wnuk	wnuka	MASC;HUM
wnętrze	wnętrza	NEUT
woda	wody	FEM
wodniczka	wodniczki	FEM
wodociąg	wodociągu	MASC;INAN
wodospad	wodospadu	MASC;INAN
wodzidło	wodzidła	NEUT
wojak	wojaka	MASC;HUM
wojewoda	wojewody	MASC;HUM
województwo	województwa	NEUT
wojna	wojny	FEM
wojownik	wojownika	MASC;HUM
wojsko	wojska	NEUT
wokalista	wokalisty	MASC;HUM
wola	woli	FEM
wole	wola	NEUT
wolt	wolta	MASC;INAN
wombat	wombata	MASC;ANIM
worek	worka	MASC;INAN
wosk	wosku	MASC;INAN
woskówka	woskówki	FEM
wozówka	wozówki	FEM
wołacz	wołacza	MASC;INAN
woń	woni	FEM
woźna	woźnej	FEM
woźny	woźnego	MASC;HUM
wrażenie	wrażenia	NEUT
wrotycz	wrotycza	MASC;INAN
wrończyk	wrończyka	MASC;ANIM
wrzawa	wrzawy	FEM
wrzeciądz	wrzeciądza	MASC;INAN
wrzemię	wrzemienia	NEUT
wrzesień	września	MASC;INAN
wrzosowisko	wrzosowiska	NEUT
wrzód	wrzodu	MASC;INAN
wróg	wroga	MASC;HUM
wróżba	wróżby	FEM
wróżka	wróżki	FEM
wschód	wschodu	MASC;INAN
wspomnienie	wspomnienia	NEUT
wspornik	wspornika	MASC;INAN
wspólnota	wspólnoty	FEM
współczynnik	współczynnika	MASC;INAN
współpracownik	współpracownika	MASC;HUM
wstrząs	wstrząsu	MASC;INAN
wstążeczka	wstążeczki	FEM
wstęp	wstępu	MASC;INAN
wszechświat	wszechświata	MASC;INAN
wtopa	wtopy	FEM
wulgaryzm	wulgaryzmu	MASC;INAN
wybieg	wybiegu	MASC;INAN
wyborca	wyborcy	MASC;HUM
wybraniec	wybrańca	MASC;HUM
wybuch	wybuchu	MASC;INAN
wybór	wyboru	MASC;INAN
wychowanek	wychowanka	MASC;HUM
wychowanka	wychowanki	FEM
wycieczka	wycieczki	FEM
wycieraczka	wycieraczki	FEM
wydanie	wydania	NEUT
wydarzenie	wydarzenia	NEUT
wydawnictwo	wydawnictwa	NEUT
wydech	wydechu	MASC;INAN
wydma	wydmy	FEM
wydział	wydziału	MASC;INAN
wygibas	wygibasu	MASC;INAN
wygnanie	wygnania	NEUT
wygnaniec	wygnańca	MASC;HUM
wygoda	wygody	FEM
wygłup	wygłupa	MASC;INAN
wyjec	wyjca	MASC;ANIM
wyjątek	wyjątku	MASC;INAN
wyjście	wyjścia	NEUT
wyka	wyki	FEM
wykałaczka	wykałaczki	FEM
wykopalisko	wykopaliska	NEUT
wykres	wykresu	MASC;INAN
wykrzyknik	wykrzyknika	MASC;INAN
wykładnia	wykładni	FEM
wylew	wylewu	MASC;INAN
wymiana	wymiany	FEM
wymiar	wymiaru	MASC;INAN
wymuszenie	wymuszenia	NEUT
wymówka	wymówki	FEM
wynalazca	wynalazcy	MASC;HUM
wynik	wyniku	MASC;INAN
wypadek	wypadku	MASC;INAN
wypoczynek	wypoczynku	MASC;INAN
wyprzedaż	wyprzedaży	FEM
wyraz	wyrazu	MASC;INAN
wyrażenie	wyrażenia	NEUT
wyrko	wyrka	NEUT
wyrocznia	wyroczni	FEM
wyrok	wyroku	MASC;INAN
wyrzutek	wyrzutka	MASC;HUM
wyrzutnia	wyrzutni	FEM
wyrób	wyrobu	MASC;INAN
wyróżnik	wyróżnika	MASC;INAN
wysokość	wysokości	FEM
wyspa	wyspy	FEM
wysypka	wysypki	FEM
wyszukiwarka	wyszukiwarki	FEM
wyszywanka	wyszywanki	FEM
wytrysk	wytrysku	MASC;INAN
wywar	wywaru	MASC;INAN
wywód	wywodu	MASC;INAN
wyznacznik	wyznacznika	MASC;INAN
wyznanie	wyznania	NEUT
wyzwanie	wyzwania	NEUT
wyłącznik	wyłącznika	MASC;INAN
wyścig	wyścigu	MASC;INAN
wyż	wyżu	MASC;INAN
wyżeł	wyżła	MASC;ANIM
wyżyna	wyżyny	FEM
wzgląd	względu	MASC;INAN
wzmacniacz	wzmacniacza	MASC;INAN
wzorzec	wzorca	MASC;INAN
wzrost	wzrostu	MASC;INAN
wzwód	wzwodu	MASC;INAN
wzór	wzoru	MASC;INAN
wóda	wódy	FEM
wódka	wódki	FEM
wódz	wodza	MASC;HUM
wór	wora	MASC;INAN
wóz	wozu	MASC;INAN
wózek	wózka	MASC;INAN
wół	wołu	MASC;ANIM
wądół	wądołu	MASC;INAN
wągier	wągra	MASC;INAN
wąs	wąsa	MASC;INAN
wątroba	wątroby	FEM
wędka	wędki	FEM
wędkarz	wędkarza	MASC;HUM
wędlina	wędliny	FEM
wędrowiec	wędrowca	MASC;HUM
wędrówka	wędrówki	FEM
wędzidło	wędzidła	NEUT
węgier	węgra	MASC;HUM
węgierka	węgierki	FEM
węglan	węglanu	MASC;INAN
węglowodór	węglowodoru	MASC;INAN
węgrzyn	węgrzyna	MASC;HUM
węzeł	węzła	MASC;INAN
władca	władcy	MASC;HUM
władza	władzy	FEM
włamanie	włamania	NEUT
właściciel	właściciela	MASC;HUM
właściwość	właściwości	FEM
włoch	włocha	MASC;HUM
włos	włosa	MASC;INAN
włoszka	włoszki	FEM
włość	włości	FEM
włócznia	włóczni	FEM
włóczęga	włóczęgi	MASC;HUM
włókno	włókna	NEUT
zabawa	zabawy	FEM
zabawka	zabawki	FEM
zabobon	zabobonu	MASC;INAN
zachcianka	zachcianki	FEM
zachowanie	zachowania	NEUT
zachód	zachodu	MASC;INAN
zadanie	zadania	NEUT
zadośćuczynienie	zadośćuczynienia	NEUT
zadupie	zadupia	NEUT
zadyma	zadymy	FEM
zagadka	zagadki	FEM
zaganiacz	zaganiacza	MASC;ANIM
zagroda	zagrody	FEM
zagrożenie	zagrożenia	NEUT
zaimek	zaimka	MASC;INAN
zainteresowanie	zainteresowania	NEUT
zajawka	zajawki	FEM
zajazd	zajazdu	MASC;INAN
zajęcie	zajęcia	NEUT
zajęczak	zajęczaka	MASC;ANIM
zakalec	zakalca	MASC;INAN
zakaz	zakazu	MASC;INAN
zakała	zakały	FEM
zaklęcie	zaklęcia	NEUT
zakon	zakonu	MASC;INAN
zakonnica	zakonnicy	FEM
zakonnik	zakonnika	MASC;HUM
zakręt	zakrętu	MASC;INAN
zakład	zakładu	MASC;INAN
zakładka	zakładki	FEM
zakładnik	zakładnika	MASC;HUM
zaległość	zaległości	FEM
zaleta	zalety	FEM
zalew	zalewu	MASC;INAN
zalogowanie	zalogowania	NEUT
zalotnik	zalotnika	MASC;HUM
zalążek	zalążka	MASC;INAN
zamach	zamachu	MASC;INAN
zamachowiec	zamachowca	MASC;HUM
zamawiaczka	zamawiaczki	FEM
zamrażarka	zamrażarki	FEM
zamówienie	zamówienia	NEUT
zapach	zapachu	MASC;INAN
zapalenie	zapalenia	NEUT
zapalniczka	zapalniczki	FEM
zapas	zapasu	MASC;INAN
zapałka	zapałki	FEM
zapiekanka	zapiekanki	FEM
zaplecze	zaplecza	NEUT
zapora	zapory	FEM
zapożyczenie	zapożyczenia	NEUT
zaprzaniec	zaprzańca	MASC;HUM
zapytanie	zapytania	NEUT
zapłata	zapłaty	FEM
zaraza	zarazy	FEM
zasada	zasady	FEM
zasilacz	zasilacza	MASC;INAN
zaskroniec	zaskrońca	MASC;ANIM
zasobnik	zasobnika	MASC;INAN
zaspa	zaspy	FEM
zasób	zasobu	MASC;INAN
zasłona	zasłony	FEM
zatoka	zatoki	FEM
zawada	zawady	FEM
zawartość	zawartości	FEM
zawciąg	zawciągu	MASC;INAN
zawieranie	zawierania	NEUT
zawilec	zawilca	MASC;INAN
zawistnik	zawistnika	MASC;HUM
zawodnik	zawodnika	MASC;HUM
zawód	zawodu	MASC;INAN
zaćmienie	zaćmienia	NEUT
założyciel	założyciela	MASC;HUM
zbieg	zbiega	MASC;HUM
zbiornik	zbiornika	MASC;INAN
zbir	zbira	MASC;HUM
zboże	zboża	NEUT
zbrodnia	zbrodni	FEM
zbrojarz	zbrojarza	MASC;HUM
zbytek	zbytku	MASC;INAN
zdanie	zdania	NEUT
zdarzenie	zdarzenia	FEM
zderzak	zderzaku	MASC;INAN
zdjęcie	zdjęcia	NEUT
zdradnica	zdradnicy	FEM
zdrajca	zdrajcy	MASC;HUM
zdrajczyni	zdrajczyni	FEM
zdrobnienie	zdrobnienia	NEUT
zebra	zebry	FEM
zegar	zegara	MASC;INAN
zegarek	zegarka	MASC;INAN
zegarmistrz	zegarmistrza	MASC;HUM
zenit	zenitu	MASC;INAN
zespół	zespołu	MASC;INAN
zeznanie	zeznania	NEUT
zgaga	zgagi	FEM
zgar	zgaru	MASC;INAN
zgliszcze	zgliszcza	NEUT
zgon	zgonu	MASC;INAN
zgorzel	zgorzeli	FEM
zgraja	zgrai	FEM
zgred	zgreda	MASC;ANIM
zgromadzenie	zgromadzenia	NEUT
zgrubienie	zgrubienia	NEUT
zgryzota	zgryzoty	FEM
zgrzebło	zgrzebła	NEUT
zguba	zguby	FEM
ziarno	ziarna	NEUT
ziele	ziela	NEUT
ziemianin	ziemianina	MASC;HUM
ziemianka	ziemianki	FEM
ziemniak	ziemniaka	MASC;ANIM
zima	zimy	FEM
zimorodek	zimorodka	MASC;ANIM
ziobro	ziobra	NEUT
ziom	zioma	MASC;HUM
ziomal	ziomala	MASC;HUM
ziomek	ziomka	MASC;HUM
zięba	zięby	FEM
zięć	zięcia	MASC;HUM
zjawisko	zjawiska	NEUT
zjazd	zjazdu	MASC;INAN
zjeb	zjeba	MASC;ANIM
zjebka	zjebki	FEM
zlecenie	zlecenia	NEUT
zlew	zlewu	MASC;INAN
zlewisko	zlewiska	NEUT
zlewozmywak	zlewozmywaka	MASC;INAN
zmartwienie	zmartwienia	NEUT
zmartwychwstanie	zmartwychwstania	NEUT
zmarły	zmarłego	MASC;HUM
zmiana	zmiany	FEM
zmierzch	zmierzchu	MASC;INAN
zmiękczenie	zmiękczenia	NEUT
zmysł	zmysłu	MASC;INAN
zmywarka	zmywarki	FEM
znaczenie	znaczenia	NEUT
znajoma	znajomej	FEM
znajomość	znajomości	FEM
znajomy	znajomego	MASC;HUM
znak	znaku	MASC;INAN
znamię	znamienia	NEUT
znieczulenie	znieczulenia	NEUT
znój	znoju	MASC;INAN
zorza	zorzy	FEM
zołza	zołzy	FEM
zszywacz	zszywacza	MASC;INAN
zszywka	zszywki	FEM
zwarcie	zwarcia	NEUT
zwiad	zwiadu	MASC;INAN
zwiastun	zwiastunu	MASC;INAN
zwierciadło	zwierciadła	NEUT
zwierzchnik	zwierzchnika	MASC;HUM
zwierzątko	zwierzątka	NEUT
zwierzę	zwierzęcia	NEUT
zwitterjon	zwitterjonu	MASC;INAN
związek	związku	MASC;INAN
związkowiec	związkowca	MASC;HUM
zwojnica	zwojnicy	FEM
zworka	zworki	FEM
zwrot	zwrotu	MASC;INAN
zwrotka	zwrotki	FEM
zwrotnica	zwrotnicy	FEM
zwrotnik	zwrotnika	MASC;INAN
zwycięstwo	zwycięstwa	NEUT
zwycięzca	zwycięzcy	MASC;ANIM
zybuczkowiec	zybuczkowca	MASC;INAN
zygotarianin	zygotarianina	MASC;HUM
ząb	zęba	MASC;INAN
ząbek	ząbka	MASC;INAN
zło	zła	NEUT
złocień	złocienia	MASC;INAN
złoczyńca	złoczyńcy	MASC;HUM
złotnik	złotnika	MASC;HUM
złoty	złotego	MASC;INAN
złotówa	złotówy	FEM
złotówka	złotówki	FEM
złożenie	złożenia	NEUT
ósemka	ósemki	FEM
ćwiartka	ćwiartki	FEM
ćwiczenie	ćwiczenia	NEUT
ćwiek	ćwieka	MASC;INAN
ćwierć	ćwierci	FEM
ćwierćdolarówka	ćwierćdolarówki	FEM
łabądź	łabędzia	MASC;ANIM
łachman	łachmanu	MASC;INAN
łada	łady	FEM
ładowarka	ładowarki	FEM
ładunek	ładunku	MASC;INAN
łagiew	łagwi	FEM
łajba	łajby	FEM
łamana	łamanej	FEM
łapa	łapy	FEM
łapówka	łapówki	FEM
łasica	łasicy	FEM
łaska	łaski	FEM
łata	łaty	FEM
ława	ławy	FEM
ławeczka	ławeczki	FEM
ławka	ławki	FEM
łazienka	łazienki	FEM
łańcuch	łańcucha	MASC;INAN
łaźnia	łaźni	FEM
łeż	łży	FEM
łgarz	łgarza	MASC;HUM
łodzik	łodzika	MASC;ANIM
łokieć	łokcia	MASC;INAN
łom	łomu	MASC;INAN
łopatka	łopatki	FEM
łosiek	łośka	MASC;ANIM
łosoś	łososia	MASC;ANIM
łoszak	łoszaka	MASC;ANIM
łotyszka	łotyszki	FEM
łoza	łozy	FEM
łozówka	łozówki	FEM
łoś	łosia	MASC;ANIM
łożysko	łożyska	NEUT
łubin	łubinu	MASC;INAN
łuczniczka	łuczniczki	FEM
łucznik	łucznika	MASC;HUM
ług	ługu	MASC;INAN
łuk	łuku	MASC;INAN
łuna	łuny	FEM
łuska	łuski	FEM
łycha	łychy	FEM
łydka	łydki	FEM
łyko	łyka	NEUT
łyska	łyski	FEM
łysol	łysola	MASC;HUM
łyżka	łyżki	FEM
łyżwa	łyżwy	FEM
łza	łzy	FEM
łódeczka	łódeczki	FEM
łódka	łódki	FEM
łódź	łodzi	FEM
łóżko	łóżka	NEUT
łącze	łącza	NEUT
łączka	łączki	FEM
łącznik	łącznika	MASC;INAN
łęk	łęku	MASC;INAN
ściana	ściany	FEM
ścieg	ściegu	MASC;INAN
ściema	ściemy	FEM
ściereczka	ściereczki	FEM
ściernisko	ścierniska	NEUT
ścieżka	ścieżki	FEM
ściółka	ściółki	FEM
ściąga	ściągi	FEM
ślad	śladu	MASC;INAN
ślaz	ślazu	MASC;INAN
śledziennica	śledziennicy	FEM
śledziona	śledziony	FEM
śledź	śledzia	MASC;ANIM
ślepie	ślepia	NEUT
ślepiec	ślepca	MASC;HUM
ślimacznica	ślimacznicy	FEM
ślimak	ślimaka	MASC;ANIM
ślina	śliny	FEM
ślinotok	ślinotoku	MASC;INAN
śliwa	śliwy	FEM
śliwowica	śliwowicy	FEM
śloza	ślozy	FEM
ślub	ślubu	MASC;INAN
śluz	śluzu	MASC;INAN
śmiałość	śmiałości	FEM
śmiech	śmiechu	MASC;INAN
śmieciarka	śmieciarki	FEM
śmieciarz	śmieciarza	MASC;HUM
śmieciówka	śmieciówki	FEM
śmierdziel	śmierdziela	MASC;HUM
śmiertelnik	śmiertelnika	MASC;HUM
śmierć	śmierci	FEM
śmietana	śmietany	FEM
śmietnik	śmietnika	MASC;INAN
śmieć	śmiecia	MASC;INAN
śmigło	śmigła	NEUT
śmigłowiec	śmigłowca	MASC;INAN
śniadanie	śniadania	NEUT
śnieżyca	śnieżycy	FEM
śpiewaczka	śpiewaczki	FEM
śpiewak	śpiewaka	MASC;HUM
śpioch	śpiocha	MASC;HUM
śpiwór	śpiwora	MASC;INAN
śpiączka	śpiączki	FEM
średnia	średniej	FEM
średnica	średnicy	FEM
średnik	średnika	MASC;INAN
środa	środy	FEM
środek	środka	MASC;INAN
środowisko	środowiska	NEUT
śruba	śruby	FEM
śrubeczka	śrubeczki	FEM
śrubka	śrubki	FEM
śródmózgowie	śródmózgowia	NEUT
śródrostek	śródrostka	MASC;INAN
świadectwo	świadectwa	NEUT
świadek	świadka	MASC;HUM
świat	świata	MASC;INAN
światopogląd	światopoglądu	MASC;INAN
światło	światła	NEUT
światłość	światłości	FEM
świder	świdra	MASC;INAN
świeca	świecy	FEM
świecznik	świecznika	MASC;INAN
świekra	świekry	FEM
świerk	świerka	MASC;INAN
świerszcz	świerszcza	MASC;ANIM
świerszczyk	świerszczyka	MASC;ANIM
świr	świra	MASC;HUM
świstak	świstaka	MASC;ANIM
świstun	świstuna	MASC;ANIM
świt	świtu	MASC;INAN
świątynia	świątyni	FEM
święconka	święconki	FEM
święto	święta	NEUT
święty	świętego	MASC;HUM
źdźbło	źdźbła	NEUT
źrebię	źrebięcia	NEUT
źrenica	źrenicy	FEM
źródło	źródła	NEUT
żaba	żaby	FEM
żagiew	żagwi	FEM
żaglówka	żaglówki	FEM
żakiet	żakietu	MASC;INAN
żal	żalu	MASC;INAN
żar	żaru	MASC;INAN
żargon	żargonu	MASC;INAN
żart	żartu	MASC;INAN
żaróweczka	żaróweczki	FEM
żarówka	żarówki	FEM
żarłok	żarłoka	MASC;HUM
żbik	żbika	MASC;ANIM
żebraczka	żebraczki	FEM
żebrak	żebraka	MASC;HUM
żebro	żebra	NEUT
żeglarka	żeglarki	FEM
żegluga	żeglugi	FEM
żelazko	żelazka	NEUT
żelazostop	żelazostopu	MASC;INAN
żeneta	żenety	FEM
żeniec	żeńca	MASC;HUM
żer	żeru	MASC;INAN
żerdka	żerdki	FEM
żerdź	żerdzi	FEM
żerowisko	żerowiska	NEUT
żniwiarz	żniwiarza	MASC;HUM
żniwo	żniwa	NEUT
żona	żony	FEM
żonkil	żonkila	MASC;ANIM
żołna	żołny	FEM
żołnierz	żołnierza	MASC;HUM
żubroń	żubronia	MASC;ANIM
żuk	żuka	MASC;ANIM
żul	żula	MASC;HUM
żuraw	żurawia	MASC;ANIM
żwir	żwiru	MASC;INAN
życie	życia	NEUT
życiorys	życiorysu	MASC;INAN
życzenie	życzenia	NEUT
żydek	żydka	MASC;HUM
żyletka	żyletki	FEM
żyrandol	żyrandola	MASC;INAN
żyroskop	żyroskopu	MASC;INAN
żywica	żywicy	FEM
żywiciel	żywiciela	MASC;HUM
żywokost	żywokostu	MASC;INAN
żywopłot	żywopłotu	MASC;INAN
żywot	żywota	MASC;INAN
żółtko	żółtka	NEUT
żółw	żółwia	MASC;ANIM
żółwik	żółwika	MASC;ANIM
żądło	żądła	NEUT
żłób	żłoba	MASC;INAN
żłóbek	żłóbka	MASC;INAN
